A------█-█---█---█-------------█-----█-█-------------█-----█-█-█-█-------█-------------█-█---█-------
-███-███-███-█--██-██----███████--████-█-███-█-█████-███-███-█-█-█--██████---██-████--██-█-███-█-█-█-
---█---------------█-█-█---------█-█---------------------------------------█-█-----█---------█-------
-███-█-███---██████--██-██-█-███---█-█-█████-███-██--█-█-███-█-█-█-█-█-███-███-███-█-█-█████-███-█-█-
-------█-█-█---------█-█-█-█---█-----█-█-█-█-----█-█-█-█-█---█-----------█-█-█---█-----█---█-█---█-█-
-█-█-███-███--██--████-█-█-█---███-███---█-█---██--███-███-███████-█-███████-███--█--██--██--█-█-█-█-
-█---------█---█-----------█---█-----█---█---█-█-----------█-----█-█-----------█-------█-----█-█-█-█-
-█-█--██-█████████████████-███-█████-█-█-█-█████-██████-██-█-█-█-█-██--█-█---████---██---█-█-█--█████
-█-█-█-----█---█-----█-█-----█-█-----------------█-------█-------------█---█-█-█-█-█-█-█-------█---█-
-█-███-█-█-█-█-█-█-█---█-█████-█-█-███-███-█-█-███-█-█-███-█-█-█-█--██-██-██-█-█-█-█-█-█-█-█---█-█-█-
-█-█-----█-------█-█---------------------█-█-------█-█-█-█-█-█---█---█-------------█---█-█-█-█---█---
-█---███-████----█-█-█-███-█-█-███-██-████-███--█████--█-█████-███-█-█-████-█--█-█████-█-█-█-█-█████-
-█-█-█-------█-█-----█-------█---█---█-------█---█-█-█-█-----█---█-█-█-------█-█---█-----█-█-█---█---
-█---█-█-███-█-█-███-███-█-██-██--██-███-███-█-█-█-█-███-█-████-██-████-██████-█-███-█-█-█-█-██--████
-----█-█-█---█-█---------█-------█-█-------█-█-----------█---█---█-█-----█-█-█-█---█-----------█---█-
██-█-█--██-█-█-█-█-█-█-███-█-███-█--██████-█-███-█-███████-█-███-███-█████---█-█-███-█-████████--███-
---------█-█---█-█-█-█---█-█-----█---------█-█-█-█-----█---█-█-█-----█-----█---█---------------█-█---
██████-█-███---█████-█████---█-█-█-██--███████-█-███-█-█-███-█-█-█-███----████-█-█-███████████████-██
-------█---█-█-█-█-█---█---█-█-█---------█-----------█-█-█-----█-------------------------------------
-█-█████--████-█---█-███-███-█-███-███-███-███-█-█-███-█-█----██-█-█-█-███-███-█-█████-█-█-█-█--██-█-
-█---█---█-----█-----█---█-█-█---█-----------█-█-----█-█-█-█-----█-█-█-------█-█-----█-------█---█-█-
██████-█-█-████--█-█-█---█-█---█████-█-███-██-█-██--████-██-█--█-█-█-█-█-█-███-█-█-███████-███-█-███-
-------█---------█-█-█-█-█---█-------█-█-█-----------█-█-█-----█-█-----█---█-█-█-█-█-------------█---
████-███-█-█-███--████-███-███-███-██-██--██-█-█-███-█-█-█████-█-█--████-█-█-█-█-██--████--█---█---█-
-----█-----█-█-------------█-█-█-----------█-█-█-█---█---█---█---------█-█---█---------█---█-------█-
██-█--██--██-█-███-█---█████--██-██--███-█████████-██--█-███-█-███-█-███-█-███---█-███-█--████-██----
-----█-----█-█---█---█-----█-----█-█---------█-----------------█-█-█---█-█-█-█---█---█-█---█---------
██-████--█-█-█-█-█-███-█-███--██-█-█████-███-█-██--█-███████-███-█--████████----██-█-█-----█-█-█-█-██
-█-----█-█-█---█-█-----█---------------█---█-█-----█-----█-----█-█---█-------█-█---█-█-------█-█-█---
-█-█-███-███-█-███████-████--█-███-█-███--██-█-███-███---█-█--█--███████-█-███████-██--█████-███-█-█-
---█---█-█---█-----------█---█-------------█-█---█---█-█---█-----------█-█-█---█-----█---█-█---█-█---
-█-█---█---███-████-█--███--██-█-██-████-███-█-█-███████████-█-█-█-█████--██-███-█-█-███-█-██-██-█-█-
-█-█-█-█-█-█-------█-------█-█-█-----------------------█---█-█---█---------------█-█---█-█-----█-█-█-
-███---███--█-████-█████-█-█---█-█-█-█-█████-█-███████████-█-█-█-█-█-█-█-███-█████-█-█-███-█-████████
---█---█---------█-█-█---█-█-█-█-█-█---------█---------█-----█-█-█-█-----█-█-----█-█-█-█-█-█---█-----
-███-█-███-█-███--██-█-███-█--████-█---█--████--████-██--█-█████-█-█--████-███-███-███-█-█-██-██-████
-------█---█---█-█-----█-------█---█-█-█---█---------------█-█---█-█-------█-█---█---█-------█-█-----
██-█-███-█---█-█-█████-███-█-███-█-███-█-█-███-█-█--██-█-█---███---█-███-███-█--████--██-█-███-█-██--
---█---█---█-█-█---█-█---█-█-█---█---█-█-----█-█-█---█-█-----█---█-█-------█-█-----█-█---█---------█-
-█-█-███-██--█-████--██-██-█-███-█████-█-███-███-████-███████--███--██---███--██-█-█-█-█-█-█---███-█-
-------█-------------------█-----█---------------------------█-█-----█-----------█-█-█-█-█-█-█---█-█-
-█-█---█-███-███--██-█-█-█-█-█████████---█--██-█-█-█-█-███-█---█-█-█-██---██-███-██-████-█-█-█-█████-
-----------█-█-----█---█-█-█-------█---------█-█---█-█-█---------█---█-----█---------█---█-----------
██-█-██--█-█████-█-███---█-█████---█████-█-█-█████-███-█-█---█-█-█-███---█-█-█-███-█-█-█-███-█-███-██
-█-------█-------█-----█-█---█---█-█-----█-█-----█---█-█---█-█-█-█-----█-█-█-█---------█-----█-------
-██----█-█-███--█-█--███-█-█████-███-█-█--███████-███-██--████-███-█-█-███-███-██-██-███-███-███-█-██
-----█-█---█-----█-------█-█---------█-█-----------█-------------█-█-█-█-----█---█---█-█-█-------█---
████-███-█---██-██-█---█████-█-███████-█-█-███-█-███-█-█-███-█-█-█-█-███--██--████--██--████-███████-
---------█-█-█-----█---█-█-█-----█-------█---█-------█-█---█-█-█-█-█---█-█---------█-█---█-----------
-█-███-███--█--█-█-█-███-█-█-███-███-██---████-█-███████-█████-█-█-███████--████-█-█-█-███-█-██████--
-------█-█-----█-█-----------█-█---█---█---█---█-------█-█-------█-----█-------█-----█-----------█-█-
██████-█-███-█-█-███---█-█-█-█-█████████---█████---███-███-█-███-█-███-█-█-█-█---███-█-█-███-█-███-█-
---------█---█-█-----█---█-█-------█-------█---------█-----█-█---█-█-█---█-█-█-█---█---█-----█-----█-
█-████-████--█--█--█-███---█-█████-█-███-███---█████-█-███--██-█████-██-████--██---███████-███-███-█-
---------█-█-█-█---█-█---█-------█-█-█-------█-█-█-------█-█-----------█---█-█---█---█-█-█-█-█---█-█-
█████--█---███████--████-█-██--█-█-█-███-███-█-█-█████████-█--██-███-███-█--██-█-█-███-█---█-█-███---
-█-█-█-█---------█---█-█-█-█---█-█---█-----█-█-----█-----█-----█-█---█---█---█-█-█-----------█-█-█-█-
-█-█-█████-█-█-███---█-█-█-███-██-██████-█-█-█-█-█████-█-██-████-█-█-█--████-█--████████-█-███---█-█-
-----------█-█-█-█-█---------█-█-----█---█-█---█-------█-----------█---█-----------------█-------█-█-
█--███-█-█████-█-█-█████-█████-█-█-█-███-███-█-█-███-█--████-██-██-█-███████-███-███████-█-█-███-█-██
---█---█---------------█-█-----█-█-----█-█---█-█---█-------------------█-█---█-█-------█-█-█---█-----
---████---███--███-█-█-███████-█-█-█████-█████-█-█████-███---█████-█████-████--███-███████-██-██--███
-----█-------█-█---------█-------------█-------█-----█-----█-█-█-█-█-----█---------------█-█-█---█---
--█-██-█---█-███-█-█-████--███-█-███-█-█████-█-███-█-███-█-█-█-█-███-█████-█--█-█████-██████---█---██
---█---█-█-█-----█-------█-█-------█-█-█---█---█---█-█---█-█-----------------------------------------
██--█--██---██-█-█-███-█-███-█-███---███---████--█---████-██-█-█-███--█████-██-█-███-█-███-█---█-█---
---█-------█---█---█---------█-█-█---█---█-----█-█-█-----█---█---█-█---------█-█---█-█-------█-------
-█-█-█-█-███-█-█-█-█████-----███---█-█-███-█-█████-█-█--██-█-█-█-█-████-██-█-██-█-█-████-█-███-██████
---█-█-█---█-█-█-█---█---█---█-█-----------█---█-█-█-----█-█-█-█-----█-█-█-█-----█---█---------------
██-█---█-█-█-█-█---██-████-█----██--█-██-███-███-██--██-██-█-█-██-██-█-█---██--███-████-----█--███-█-
-█-█-█-█-█-█---█-----█-█---█---█-------------█-----█-----█-█-█---█---------------█---█---█-█-----█-█-
-█-█-███--██-█-███-█-█-█-█-███-█-█-███-███-██--█-██████--█---█-███--███--███-█-██--█-█-██--███----███
-----█-█-----█---█-█---█---█---█-----█-------█-█-------█-█-█-█-█-----█-----█-█-█---█-----█-█---█-----
-█-██----███-█---█-█-█-█-█-███----██-███--█--█-████-███-██████-█-----███-█-█-█-█-█-███--██-███-██--██
-█-█-----█-------█-█---█-█-█---█---█---█---█-----█---------█---█-█---█---█-█-----█---█-█-█-----█-----
-███-█-█-█-███-███-█████-███-██--██████--█-███-███-███-█-███-███-█--████-███--██-███-███-███-█-█████-
-█-█-█-----█---█-------█---█-----█-----█-█-█-█-------█-----█---█-█-------█-----█---------█-█-----█---
██-█████-█-█-███--█---██-█-█-█-█-█--██-███-█-███-█████-█-███-███-█---█████--█--█-█-█--██-█---█-------
---------█-█-----█---█-----█-█-█-----█---█-----█-█-------█-----█-█-----------█-█-█-----█-----█---█-█-
██-█-█-█-███--██-█-███-█--██-█---█-██-██-█-███-█-█-█--██-███-█-█████-█--██-█---███-█--██-█-███-███-█-
---█-█-█-█---█-----█-----█-----█-█---█---█-----█-------█-█---------█-------█-█---█-█---█-█-█-█-----█-
-███████-███-█-███---███-██-██-█-███-█-█--██---█████-██--███-█-███-███-██████--███-█---█---█-███-█-█-
-----█-----█-█---█-█-█---█-----█-█-----█---█-------█---------█---█-█-----█-------█-█-----█-----------
████-███-██-██-███-█---█-███-█-█████-█--█--█-███-█--██---██----█-██--█-███-███-█-█████-█-█-█-██---██-
-------------█-----█---█---█-----█---█---█-----█-█-----█---█-█-█-█-----------█-█-------█-█-------█---
████-██-███-----███----███--██-█-█-█---█--██-█-███-███---█-█--███--███-█-█-█████-█-█-███-█-███-██--██
-----------█---█-█-█---------█-----█-█-----█-█-█---------█-█---█-----█-█-█-█-█-█-█-█-█---█---█-------
-█---█--████-███-█-█-█---█-███-█--██---█-██--███-█-█-█-█-███--████-███-█-█-█-█-█████-█-██--█-█--████-
-█-█-█-----█-------█-█-█-█-█---█-----█-----█-█---█-█-█-------------█-------█-█-█---█-█-█---█-█-------
--██-█-█-██████-██████--█████-█-██-█-███--████-███-█-██--█-███-███-█████-█-█-█-█--██████████-█-█-███-
-█-█-█-█---------█---█-----█-------█-------█---█---█-█-█-█---█-----█-----█-------------█-█-█-█-█-█G--
---█--██-██-█-██-█-███-█-███-█-█-█---█---███-█████-█-█-███-█-█-██--████--█-█---██--█-█-█---██-██████-
---█-█-------█-------█---█---█-█-█-█-█-█-█-█---█---█-----█-█-█---█-----█-----█-----█---------█---█---
██-█--██-███-█-███████-█-█--█-████-███-███-█--██----████-█-█--████-███-███---█-█---█-██-███--█---█--█
---------█---█-█-------█-------█---█-------------█---█-█-█-------█-█-------█-█-█-█-█-----------█---█-
-█-█████-███-█-█-█████████-████-██-█-███-███-█----██-█-███-███-█-█-█---███-█-█████-███-███--████████-
-█-------------------█---------█-█---█-█-█---█-█---█-█-█-█---█---█-█-█-█---------█-█---█-█-------█-█-
-█---███---█-█-█-█-███-█-█---███-██--█-█-█-███-█-█████-█-█-███-███-█████-█---██---██-█-█-█-███-█-----
---------█---█-█-█-------█-█-█-█-█-----█-█---█-----------█-█-█-█-----█---█-----█-█---█---------█-----
---██-████-█--██-█-███-███-██--█-█-█-███-█-███-██-█----█-███-█-█-█-██-████-███-███-█-███-█████-----█-
-█-█---------█-------█-----------█-----------█-----█-█-█-----█-------█-----------█-------------█-----
90 98