A--█---------------------------------------------█---█-█---------█-█-------█-█---█-------█-█---█-----
██-█-█-█-██--██--███-███-███-███-█-█-█████-███████---█--██-███-███-█-█-████--█-███-█-█-█---█-█-█---█-
-----█-----█-█---█-----█-------█---------█-----------█-----█-█-----------█-█-█-█---█-█---█---█---█---
██-█-██--█-██-██-█-██████-████-█-█-███-█--████-█-----█-█-███-█████-█-████--█-█-█---█████-███-██--████
---------█-----█-█-----------█-█-█---█-█-----█---█-█-------------█---------█-█-----█-█---------█-----
---█-█-█-█████-███████████-██████--███-█-███-███-█████████-██-████-█-█-████--█-████--███-█-██--██████
---█-█-█-█-----█---█-------█---█---█-----------█-----█-----█-----█-█-█---█---------------█-----------
-█-█---█---███-█-██--█---██--██--██---██-█-█-███-█-███-█████-█-█-███-███████---███████████-█-█-██-██-
-█-----█-----------█-█-█-█-█-█-----█---█-█-█---█-█---█-------█-█---█-█-------█---█-█---█-█-█-█-----█-
-█-█-███-█-█-███████-█████-█-███-███-██-█-██-████---██-█████--██-█-█████-███---███---█-█-█-██████████
-█-█-----█-█---█-----------█---------------------█-------█-█---------------█---█-------█-----█-------
-█-█-█-█-█-██-██-███████-█-███--██-█-█-████████-██-█████-█---█████-█████████████-█-█████-█-███-██████
-█-█-█-█-------█-█-█-█-----------█-█-█-█-------█-----█-█---█-█-█-█---█---█---█-█-█---█-------█-------
██-█-███--████-█-█-█---█-█-█-███████-███-███████-█-███-█---███-█---███-███-███-█-█-█-█-█--████-█-█-█-
-----█-------█---------█-█-█-------------------------█-------█-------------------------█---------█---
-█-███-█-█--████-█-█-█---███-██████-██-█-█-█-███-█--██-█-█████-████---██-█-█-█-███████-█-█-█-█-█████-
-█-----█-█-----█-█---█-█-█-█---█-█---█-█-█-█-█-█-------█---------------█---█---------█-█-█-█---------
█--█-███-█-█-████-██-███-█-███-█-███-█████-███-█-█-█-█-█████-█-███-█-█-███-█-█-█-█-███--██-█-█-█████-
---█---█-█-█-------█-------█-----█-█-█---█-----█-█-█---█-----█---█-█-█---█-█-█-█-█-█-█-----█-----█---
-█--██--██████-█████-███-█-█-█-█-█-█---█-█-████-██-█-█-█-█-█-█-█---█-██--█-██-██-█-█-█-█-█-█████-█-██
-█---█---█-------█-------█-█-----------------------█-█---█---█-█-█-█---█-█-------█-------█---█-█-█-█-
██-███████-█-█-███-█-█-█████-█-█████-█--███████████-████-█-█--███--██--█-█--████-█-███-███-███-███-█-
-------------█-----█-█-█-█-█-█-█-█-----------█-█-------█-█-█-█---█-█---█-█-------█-█-----------------
---█-█████-███-█-█████-█-█-█-██--█-█-█-█---█-█---█-████-█████--███-█-█-██--█-█-██-████-█-██-██████-██
-█-------█-----█-----█-█-█-------█-----█-█-------█-----█---------█-█-----█-█---█-█---█-█---█-█-█-█-█-
██-███-██----███-███-███---█████-███████-███-██-████-█-█-█-████-████-██████-████-█-███-█████-█-█-███-
---------█-----█-█-------------█---█-█-------------█-█---█-------------------█---█-█---█---█-█---█---
-███-███-██-████-█-█-███-█--██--██---███-█████████-███████-█-███-█-█-█--███-██-███-█-███-███-███-█-██
---█---█-------█-█-█---█-█-█-█-█-█-------█---------------█-----█-█-█---█---------█-█---█-█---█-█-█---
-█-███-█-█-█-█████-█████-█-█---█-█-███████-█-███-█---█-██--█-█-█-█-█████---███████---██----█-█-█-█-█-
-█---█-█-█-█---█---█---█-█---------------█-█---█-█-█-----█-█-█-█-----█---------█-----█-------█-█-█---
-█-█-█-█-███-█-█████-█-██--█-█-█---███-█-█-██-██-██-█-███--██--█-█-██-██-██-█----█-█-█-█████-█-█-█-██
---█-█-----█-------█-------█-█-----█-█-█-----█-█-------█-----█-█-█-----------█---█---█-----█-------█-
████-███---█-██--█-█-█-██----█-█-█-█-███-█-█-█--██-█████--████-█-█-█-█-█-██-████-███-█-█-█-███-████--
-------█-█-█---█-█-------█-█-█-█-------█-█-█-----█-█---------█-----█-█-------█-----------------█-----
-█████--██-█████-█████-█-█---█-█-█-█-█-----█-█-█---█-█-█-███-█-███-█-█-█-█-█-██-█--█-█-█████-█-█-███-
---█-----█---█-----█---█-█-█-█-█-----█-█-█-█-----█---█-█-█-------█-------█-----█-█-█-█-█-----█-----█-
██-███-███-█-███-███-███-███-█-███-███████-█-█--██-████--█-███████-█-███---█-██--█████-███-█-█--██---
---█-----█-█---█-----█---█---█-█-----█-------█-█-------█-----------█---█-█-█-------█-█---█---█---█-█-
-███-█-█---████--█---███-███-███-█████-██-██-████--█-█-█-█-███-███-█████-███████████-███-█-█-█-█-█-█-
-----█-█-█-█-----█-█-█-----█---█-------█-█-------█-----█-█---█---█-█---------------------█-█---█-----
-█████-█-█-█-█-███████-█-█-█████-███---█-█-█---█-█-█████████████-█████-███-█-██--███-█--█████--█--███
---█---█-█---█-------█-█-█-----█-█-----█-------█-█-----█---█-------------█-█-------█-----█-----█-----
-██--█-█-█████-█-██-████-█-█-███-███████-██████--███---█-█-█-█████-█████-███-█-█-███-█-█-█-█-█--███--
---█-█-█---█---█-█-------█-█---------█-----█-----█-------█-█-█---█---█-------------█---█-█-█-█-------
-█████-████--███-█-█-███---███-███-███--██████-█-█--██-█-█-█-█-█--███-█--███--█--█████-███████-█-█-██
---█-█---█---█-----█-█---█-█-----█-------------------------------█-------------█-----█-----------█---
---█-█-█-█-███----██-███-█-█--██-█-███-███████-█---█-█-█-███-████-██-███-█████-█-█████████████-█-████
-█-----█-█-----█---█-█---█---█---█---█---------█-------█-------------█-█---█-█-█---█-----█-█---█---█-
-█-███████-███-█--██-█-█-█-█--██-█-███-███-█-█-█--██-███-█-█-███-██--█-█-███-███████-███-█-█-██---█--
-█---█-----█---█---█-------█---█-█---█---█-█-█-█---█-----█-█---█-----------------------------█-------
-█-███--██-█-███-█-█-███-█-█-██--█-███-████--█████████--████--██----█--█-███████-██--███-███-█-█-████
-█-------█-█-----------█-█-█-█---------█---█-----█---------█---█-█---------█-█-----█-█-█---█---------
-███████-█-███-█-███-█████-█-█-█-█-███-███-----███-████-██-█████████-██-██-█-███-███-█-█-████-██-████
-----█-█-█-█-------------█-█---█-----█-------█-----------█---------█---█-█-----█-----█-------█-------
-█---█--██-█-████--█-██-████-█-█-█-███-█-█-█-███-███-███-█-█--███-██-███-███████-█-█---█-███████---█-
-█-█-█---█-█-█-----█-------█-█-█-█-█-█---█-█---█---█-----█-█-------█-----------█---█---█---------█-█-
-█-█-█-████--█████---███████-██████--███--██-█-█-█-███-█-███-█-█████████-██--█-███-█--████-███-█-████
-------█-----------█-------█-----█-█-----------█-█---█-█---█-█-------------█-█-----█---------█-█-----
-█-█---█-███-█-█████-███-█-███-███-█-█-█-█-██----█-██--█-█-███-█-█-█-█-███-█-███-███████████-█-█-█--█
-█-█-----█---█-█---------█---█-----█-█-█-█-█---█-----█-----█-█---█-█---█-█-------█---------█-█-█-█---
██---███████-███-███-█-██--██--███████--██-█-█-█-████--█---█-█████---███-█-█-███-█-█-█-█-███-█-███-█-
---█-------█-----█---█-█-----█-----█-------█---█---█---------█-----█-█-█---█---█---█-█-█---█-█---█-█-
-███-███-███-███-████--█-██--█-█████-█-███-██--█-█-███-█--██-█--██--██-█-█-█-█-█-███████-█-█-█-█---█-
-█-█---█---█-█-█-------█-█---------█---█-----█-█-█---█-█-█-----█-█-█---█-█---█-----------█-█-█---█-█-
-█---████--█-█-██-██████---█-█-█████-█--██-███-███---█-██████-██-███-███-█---█-███-████████-██████---
-█-█-----█-█-------█---------█-----█-█---█-█-----█-------------------█-█-█---█---█-█---█-----█---█-█-
█--█-█-█-███---███-█████████-█-█-█--███-██--██--██-███-███-█--███--███-█-█-█-█-█-█--██---███-█-██████
-------█-█---█---------------█-█-█---------█-█-------█-█-█-█-----█-------█-█---------------█-█-█-----
████---█---██-█--███-█-█-████--█-█-███-█████--█-█--███----██-█-█--█-██-█████-█████-█-███-███-█-███-██
-----█-█-------█---█-█-----█-----█---█---█-----█---█-█-----█-█-----█-█-----█-------█---█-----------█-
-███-███-███-█-█-█-███-███--████-██--█-█-█████-███-█-█████-█-█-█-███-█-█-█████-█-█-███-███████████-█-
---█-█-------█-█-------█---█---█---█---█-█---------------█-█-█-█-----█-------█---█---------█---------
-█---███-█--██-█-█-███-███████-█-███--█-██-███-██--█-█-█-███-█--██-█-█-███-███-█---█-██--███-█---███-
---█-█---█---█-█-█-------█---------█-----█-█-----█-█-█-----█-█-█-█-█-█---█---█---█-█-█-----█-█-------
██-█████-█-█-█-█-█-█-███-█-█-█-█████-█-█-█████-███████-█-███-█-█-███-█-█-█-█-█-█-█-███-█-███-█████-██
---------█-█-█-█---█-----█---█-------█-█---█-------█---█-█---█-------█---█-█-█-------█-█---------█---
-█-█-█-█-█████--█-██-█-███████-███-█-█--█--█-█-███-█-█-█-███-████---████-█-█-███-█-███-█-█--███-██-██
-█-█-█-█-----█-----█-█-█-----█---█-----█---█-------█-------------█---█---█-█-█-█-█---------------█---
-█-█-███-█████-███-███-█████-████--█-███-█████-█-█-█-█-███-█-███-█-██-██--█--█-█-█-█-██-██-███-█████-
---█-█-------█-----█-█-█-█---------█-█-█-█-------█-█-█-█---------------█-█-----█-█-█---█-█---█-------
██-█-█-█-███-███-███-███-█-█-██████--█-███-███████████-█-█-█-█-█████--█--███-█-██--█-██--██--███--███
-----█-█---█---█-█---------█-█-------█---█-█---█---█---█---█-█---█---------█-█-----------█-█---█---█-
-█-█-███-█-█-███-█-█-█-███-███--██-█-█-█-███-█-██--█--████-█---█████-█-█-███████---███-██--█-█-█-█-█-
-------█-█-█-█---█---█-█-------█---█---------█-█-----█-----█-█-----█-█-█-----█---█---█-█-----█-█-----
----██-███-██--█--██-██----█████-█-█-███-███-███████-█--██--██-███-███-███-████----███-███-█████-█--█
-█-█-----█---█-█-------█---█-----█-----█-█-█-----█---█-----█-----█---█-█---------█---█---------█-----
-█-███-█████-█-█-███-█-█-█-█████---█--██-█-█-█---███-█-█████-███-█████████-█████████-----█-█---█████-
-█-█-█-█-------█---█-█---█---█---█-█---█---█-█-█---█-█-----------------█-----█-█-█-█-█---█-█-█-----█-
██-█-█-█████-███-█-███-█-█---█-███-█-███-█████-█-█████████-█████-█-█-█-█-██--█-█-█-█-██-██████████-█-
---█-----█-----█-█-----█-█-█-█---█-█-█-------█-█-------█-----█---█---█---█---█-----█-█-----█---█-█-█-
██-██----███-█--█-██-███-█████-█████-███-█-█-█--██-█-█-███-█---█-█-█-█-███-██--█-██-████-███-█-█-█--█
-█-█---█-█---█-----█-█---█-------█-------█---█-█---█-----█-█-█-█-█-█-█-------------------------------
-███-█-█-█-█--█------█████---███-█-███-███-█-█-███-███-███-█-█-███---█---█████-█-█-███-█--██--█--██--
-----█-█-█-█---█-█-█-█---█-----█-----█-█---█-----█---------█-----█---█-----█-----█---█---█-----█--G--
█--█-█-█-██████--███-██--█-█████-███-█-█-█-███████-█-█-█-█-█-█-█-█-█-█████-███---█-███-███-█-█-███--█
-------█-█-------█-----------█-----█-█-█-█-----█---█-█-█-█-█-█-█---█-█-------█---█-█-█-----█-█-█-█---
-█-█-███████-███████-█-█-███-█-███-█-█-█-█-█-█████████-██--█-█████████--██-███--██---███-█-█-█---█-██
-█-----█-█-----█-----█-█-█-----█-----█---█-█-----------█---█---------█---█---█-------------█---------
---█-█-█-███-███-█-█-█████-█-█-█-█-███-███-█-█████-█-████-██-███-███-█-█-████-███--███████-█████---██
-----█-------------█-----█-█-█-█---█---█---█-----█-------█---█-----█---------█-----------█-----------
94 98