A█---------█-----------█-------█---------█-█---█-█-█-█-█-----------█-------█-------█-----█-█---------
-█-█-█---███-███-██-█-██-███-█-█-██████--█-█-██--█-█-█-█-██-████-██--██---██-██-██-█-██--█-██-██-█-█-
---█-█-█-------█---█-█-█-█---█---█---█-------------█-------------█-----█-█-------------------█-----█-
--██-████-█-██-█-███-█-█-█-██----█-███---████--███-█-█-████████----█-███-█-██-██-█-████-███--███---██
-█-----------█-█-█-█-------█-█-------------█-█-----█---█-█-----█-█---█-----█-█-----█-------█-█---█---
-█-███-███-███-█-█-█-████--█-███-█-███-█-███-█-████--███-█--██████-█-█-███-█--███-██-███████-█-██████
-█---█---█---█---------------█---█---█-█-----█-----█-----------█---------█-█-█---█-█---█-█-█---------
-█-███-█-█-█-█-████-██-███-█████-█-█---██--█-█-█-███-█-██-█-██-█-█--███-██-█-███-█-█-█-█-█-█-███-█-█-
---█---█-█---█-█-█-█-█---█-----------█-█-█-█-█-█-----█-█---█---------------█---█-█---------------█-█-
-█████-█████-███-█-█--████████---█-███-█-█-█-█-████-██-█-█-█--█████-█-██--████-█-█-█-███-███-█████--█
---█-█-█-------------█---------█-█-------------█-------█-█-█---------█-█-█-------█---█-----█-█-------
-█---█-█-█████-██--█-█-█████-██████████████--█-██---████-█-█----██-███-█-█-███████-█████-█████-█-████
-█-----------█-----█---------------------█-█-█-------█-█-█-█-----█-█---------█-█-------█-----█-█-█---
-█-----███-█-█-███-███-█--████-███-██--███-█-█-█-█████-█-█---█-█████-█-█---███-█-██--███-█-███-███-██
-----█---█---█-█---█-█-█-█-█-█---█-█---------█-█-------------------█---█---█---█---█-----█-█-----█---
-█-█-█-██--██-████-█-███-█-█-█-█-█████--█--███-█-█-███-█-██-██-███-█-█--██----█--███-███-█-█-██-██-█-
---█-█---█-----█-----------█-█-----------█-------------█---█---█-----█---█---------------█-----█-█---
█--███-█████-█-█-██--███-███-███-█████-█-█-█████-██--█---███--███--██-██-█-█-█-█-████-████-█-██--█-█-
---█-----█-█---█-█-█---█-----------█---█-█-----█-█---█-█---------█---█-----█---█-------------------█-
-███--██-█-█-█-██--█-█-█-███-█-███-█-███-█---█-█████--████████-█-█--█--███████---█-██-█-███-██-█████-
-█---█-----█-█-----█-█-----█-█-█-█-█---█-█-█-█-----█-█-------█-█-█---█---█---█-█-----█-█-----█-█-----
██████-█-█-████-████----██-█-█-█-█-█-████-████-█-█-█-█-█-██--█-█--████-███-█████--██-█-█-█████---███-
-------█-█-------█---█-----------█-----------█---█-█-------█---█-----█-█-----------█-█-█---█---------
█-██-█-█-█-███-█-█████-███-███-█---█--██-█████-██--█-█---█-█-████-████-█-█-███-███████-█-█-█-█-█--███
-------█-█-█---█-█-------█-----█---█---█-█-------█---█-█-------█-------------█-----█---█-█-█---------
████-████--███-█████-█-█-█--██-█-█-█-███-█-███-███████--█--█████-█-█---█-█-███-███-██--█-█-█-███-███-
-----█-█-----█-----█-█-█---█---█-█-----------█-------█-█-█-█---------█-█-█---█---█-█-----------------
███-----█--█-█-███████-███-█--████-█-███-███████-█-█-█-█-█-█-█-█-██-███--█-██---██-█-█-█-█-█-█-█-█-██
-----█-----█-█-----█-----█-█-█---------█-█-------█---█-----------█-------█---█-█---------█-█-█-█-█---
----██-█-█-███-█--██-█-███-███---█-███-----█-█-█████-██████--█-███--████-█--██████████-███████---██--
-█-█-█-█-█-█---------█---█-------█---█-------█-----█-------------------█-█-----------█-----█-█-----█-
██----████-█-█-█-█-███████████----██-█-█-█████-██--███-█-█--█---██-----███-----█-█-███---█-█-█-███---
---█-------█-█-█-----------█---█-█---█-----------█---█-█---█-----█-█-█-█-----█-█-█---█-█-█-------█-█-
-████████-██--██-███-███-█---███-█---███████--█-██-█████--█--███████-█-----█-█-██-██--██-█---█-█--██-
-----█---------------█---█-------█-█-------------█-█---------█-----------█-█-█---█-----█-█-█-█-█---█-
-███-█-█-█████-██████--███-█--████-█-███-███--████-███-█-█-███-█-█-----█████-█-█--██-█████-█-█-█-███-
---█-----█---------█-----█-------█-------█-█-----█---█---█---------█-█-------█-█-█-------█---█-------
██-███-█████-███-█-██--█████-█--████-██-██-██-██-█-█-█-█-█--██-███████-█--████████-███-██-██-████████
---█-----------█-█-█-------█-█-█-------█-------█-█-█-█-█-----█-█-----█-█---█---█-█---------█---------
██-█-█-█-█-█-█---█-█-███-█-███-█-█-█-██--█████-█-███-█--██-█-█-█-██████████----█---██--███-███-█-████
-------█-█---█-█-█-█---█-█-█-█-█---█-------------█-█-█-█---------█---█---█-█-----█-█-----█-█---█-----
-█-█-█-█-█---█████-█-███-███-█-██████--███-█-█-██--█-█-█-█-███-█-█-███-███-█--███--█-███-████-██-█---
---█---█-█-------█-█---█-----------------█-█---█---█-----█-----█---------------█-█-█---█-------█-█-█-
-█-█-█--████-█-█-███-███-█-█--███--█-██-██--████-█-█-██--█-█-█-█-█████-████--███-█-█-███-█-██████--██
---█-█-█-----█-█-------█-█-█-█-----█-----------█-█-█---█-█-----█---------█---█---█-█---█---------█-█-
-███-███-█-█-█-██------█---██----███-███-█████-█-█-█-█-█-███--██-█████-█--██-█-███---██-██-██████--█-
-█---------█-█---█-█-█---█---█---------█---█-----█-█-█-█-█-----█---█---█---█-----█-█---█-----█-------
██-█████-█---█-█-█-███-█-█--█-██-█████---██████--███-█---█-█████-█-███-███-█-███-█-█-█-█-████-██-███-
-█---█---█-█-█---█---█-█-----█-------█-█-------█-█-█---█-█-█-----█-------------------------------█---
---███---█----████-█---█-█████-█-█-█-█---█-███-█-█---█-██-██████-█-██----█-███-███-███-█---█--██-█-██
---█-█-----█-----█-█---█-█-----█-█-█---█-█-----█-------█-█-----█-█---█-█-█-------█---█-----█-----█---
-███-█-█-█-█-███████-█-█-█-█-███-█-█--██-█-███-█-███---█-█-███████-███--██-█-█-█-█-----█████-█-███-██
---█---█-█-█---------█-█-█-█-█---█-█-█-█-------█---█-█-----█---█-█-----------█-█-█-------█-----------
-███-█---█-████--███-█-█████-███-█-███-█---█-█-█-█-███-███-█-█-█-████-██-█-█-███-███-███-█-█---███-█-
-█---█-█-------------█-----█-------------█-█-----█---█-█-----█---------█-------█-----█---█---█-----█-
-█-█-█-█-██████--█--████-█-█████---█---█-█-█-███-███-█-█-█-█-████████-██-█-█-█---███-███-███████-███-
-█-█-█-----█-█---█---█-------█---█---█-█-█-█-█-----█-█-----█-----------█-█-█-█-█---█---------------█-
-█---█-███-█-███--███-█-█--█-█-█-███-█-███████-█████████---███-█-███-█---█-█-██-██-███-██-████-█-████
-█---█-█---█-----------█---█---█---█-█-------█-------█---█---█-█-█---█-█-█-█---------█-------█-------
-███---█-█-███---█--██-█████-█-█-█████-███-███-███-----█-█-█-█████-█████-███-█-█-█--██-█-█-█████--█--
---█-█---█-█---█-█---█---█---█-█---█-----█-█-----█---█-█-█-----------------█-█---█-----█-------█---█-
████---█-█████-█---█--█████--█-█████-█-█-█-███-██-██████-██--█-█-█-███-█-█-█-███-----████--██████---█
-█---------█-------█-------█-----█---█-█-█---█-------█---█-█-█-------█-█-█-█---█-------█-------------
-█-█-█-█████████-█-█-█-██--███-█-███---██--███-████--███-█-███████-█████████-███-███-███-█-█-█-███-██
-------------█-------█---█---█-█-█---█-█-----█---█---█-█---█-----------█---█-█-----█---█-█-█-█-█---█-
████-█-█-█---██--█-███-█-███-█-███-██████--██████-███--█-█---███-███-█---█-███-██--█-███-███████--██-
-----█-█-█-█-█-------█-█-█-----█---█-------------█-█-█---█-----------█---█---█-█---█---█-█---█-█-----
---█████---█████-███-█-████---████-███-███-█-█--██-█-█-██-█--█-█-█-██--█-██-████-███-█-█-█--██--█-███
---------█-----█-----█-----█-█-----------█-█-█-█-----█-█-------█-█-█---█-----------█-█-----------█-█-
██-█-█-███-█-████████-███████████-███--███-█---█-███-█████---███████-█---█-████-████████-█-█-█████-█-
---█-█-█---█---------█-----█---█-█-------█---------█-█-█-█-█---█---█-█-█-█-------█-------█-----------
██-█-█-█-███-█-█████████-███--██-█████-████--█-█-█-███-█-███-█-█-███-████-██-█-█-███-███-███-█--█--█-
---█-█---█-------------------█---------------█-█-█-----------█-█-█-----█-----█-----█---█-█---█---█-█-
--████-███-█-█-█--██---█-█-█---███-███-███-█-█████-█-███-█-█-█-█-███-█-█-█-█-█████-███-█████-█-█-██-█
-------------█-------█-█-█-----█---█-----█-------█-█-█-█-█-█-█---█---█---█---█-█-█-----█-----█-█---█-
████-█-████-██-█--██---██-██-█-█---███-█-████--█████-█-█----██████-█-█-█-█████-█-█-██-████-███---█---
-------█-------█-█-----█-█---█-------█-█-█-----█---------█---------█-█-█---------------------█---█---
██-█-█-█-██--█-█-█-█████-███-█-█████-█-███-███-█-█-██-█--█-███-███████-█████--██-█-███-█-█-███---███-
---█-█-█-------█-----------█-----------█-------------█---█---█-----█-█-█-█-█-█---█-------█---█-█---█-
-███-█-█████-███-███-███-█-██--███-███-███-███--██-███-███-███-█-█-█-██--█--████-█-█--████-█-█-█-█-██
---█-█-----█-█-----█---█-█-----█-----█-------█-█-----█-█-------█-█---------█-█-█-█-█-----█-█---------
-█-█--███--█-█---███████-██---█-███-██-██----█-█-█-█---██----███-█---█-██--█-█-██-██-█-███-██--███-██
-█-█-█---------█-------█---█-------█---█-----█-█-█-█-------█---█-█-█-█-------------█-█-█-----█---█---
██-█-█-█---█--██-█-████--███-█-█-████--█-███---███---█-█-█---███-█---███-███-█-█-█████--██-█-█-█-██--
-------█---------█---------█-█-█---█---█---█-█-█-█---█-█-█-----█-------█-█---█-█-█-█-█-█-█-█-█-█-█---
-█--██-█-█████-█---█-█-███-███-██--█---█-█-█-█-█-█████-█-█-███-█-██-████-█-███-█-█-█-█-----█-██-█--█-
---█---█---█-----█-----------------█---█-█-█-█-------█-█---------------█---█---█-█---█---█-█---█---█-
--█--█-█-███-█-█--██--██-█████-█-███-███-███---█████-█-----█-█-█████-█-███████-█-█-███--██--██████-██
-█---█---█-----█---█-█-█-█-█-█-█---█-█---█---------█-----█-█-█-█---█-█-----█-------█-----█-----█-----
-█----██-██████--███-█-███-█-█████--██-█-████--█---█-█-██--█-█-█-███-█████-██--█-█-█-██████--█--██-█-
---█-█---█---------█---------█---█-█-█-█-------█-█-█-█-----█-█-----█-----█---█-█-█---------█-█-------
██-█-██-█--█-█-██--█-███████-███--██-█-█-█-██-██-███-███-█-█----██-----█--█████--█-███-█-███████-█-██
---█-----█---█---█-█---█---------------█-█-----█---█---█-█-█-----█---█---█-----█-█-█-----------█-█---
-█-███-█-█-███-███-███--██-██--███-█████-█-█-█-███████---███-█-██--█-█-███-█████--█-████-█-█-█████--█
-----█-█---█-----█-█---█-█-----█-----█---█---█---------█---█-█---█-█-------------------█-█-█-----█---
--██-█████-███-███-██--█-█-███-█---█---█-█-███-█-█-█-████--███-███---█-█-█-███---█-█-█-█-█-█-█-█-█-█-
---█---------█-█---------█-█---█-----█-█-█-█---█-█-█---█-------█---█-█-█-█-----█-█---█-█---█-█-█-█-█-
-███-█████-███-███-█-█-█--██-█-███-█-██--█-█-█-██--████--█-█-█-███-█----██-█-██--███-█-█-███-█-███--█
-█---█-------█-█---█-█-█---------█---█---█---█-█-█-----█-█-█-█-----█-█-█---█-█-█---█-█-█-█---█---█---
-█-█-██--█--██---█████-█-█-███-███-█-█-█-███-█-█-█-█-█-█-█----██-█-█-█-█-█--██---██--█-█-█-█-█-██████
-█-█---█-█-----█-█-----█-█---█---█-█-█-█-█---█---█---█-█-█---█-------█---█-█-------█-█---█---█--G----
100 96