A----█-█-------█-█-█---█-█---█---------------█-----█-------█---█-█-------------█-█-----█---█---------
-█-███-█-█-█████-█--█--█-█-███-█████████-█-█-█-██-██-█-███-█-███---█████-█████-█-█-██-█--█-███--██-██
-█-------█-----------------------------█-█-█-------█---█-----------█-█-█---█---█---█---█---█-----█-█-
-█-█-█-█-███-█-██--█████████-███-█████-██-█████--█████-█-█-█-██--███-█-█-█████-█---█-█-█-█-█-███-█-█-
-█-█-█-█---█-█-█-----------------------------------------█-----------------█---█-█-█-█-█-█-█---█-----
-█-█████--███-██-█-█-███-████-██████-████--███████-█-██--█-█-█-█-███-██--█████-█-█-█-█-█-█-█-█-█-███-
-█---█-------█-█-█-█-█-----------█-------█-------█-█---█-----█-█-█-█-█-----█---█---█-█-------█-------
-█-█-██----█-█-█-███-██--█-████--█-███-███-█-██-██████-█-█-█████-█-█-█-███-███-█-███-█-█-█-██----█-██
-█-█-----█-█---█---█-----------█-------█-----█-----█-█-█-█---█-----█---█-█-------------█-█-------█---
-█-█-█-█-█-█-███-██-███--█-█████-█-███████-█-█-██-██-█-███-█████-█████-█-█-█-█████-██--█████-█-█-█-██
-█-█-█-█---█---█---█-----█-------█---------------█---█-█-------█-------█---█---█---█-------█-█-█-█---
-██-████-███-███████-█-███-█-███-██--█-█-███-███-█-█-█████---███-███-█-█-█████---█-█████-█-█-█---███-
-----------------█-█-█-----█-█-------█-----█-█-█---------------█---█-----█-------█-----█-█-█-█---█---
-█-█-█████---█-█-█-█████-█-█--██-█-█-----█-█-█-███-█████-███-█-████--█-███--██-██----██--█-█-█-███-██
---█-█-----█-█---------█-█-█-█---█-█-█-█---█-------█-------█-----------█-----█-█---█-----█-█-----█---
-██-██-█-█--██-███-█-█████-█-█████---█-█-████--█-█-█-█-███-███-███████-█-███████-█---█-█-█-███████-█-
---█-----█---█-█---█-█---█-------█-----█-█-█---█-█-------█-------█-█-----------█-█-█-█-█-█-------█---
-███-█████-███-█-████-██-█-█-█-██-██-███-█-███-███-███-███████████-█████-███-█-█-█-█-█-███-█████-█-██
-█-----------█-------█-----█-█-----█-█---█-----------█-----█-█-------------█-█-█---█-----█---█-█-----
-█-█-█████-█---█-█████████-██-██████-█-███--██-█--██--█-████-███-█-█-█-██-█-██-█-███-███--██-█-██████
-█-█---█---█-█-█-------█---------█-█-----█-█-------█-----█-█-█-------█-█-█-█-█-█---█-----------------
-█-█-█████-███-█████-███-██--█-█-█-█-███-███-█-█--██-██--█-█-█--██████-█-█-█-███-█-█████-█--████-███-
-█-█-█-█-----------█-█---█---█-----█---█-----█-----█---█---------------------█---------█-█-█-█---█-█-
██-█-█-█████---█-█-█-█-███----██-█-█-███-██-██-████--█-█---█---█-█----██-█-█-█-█-█-█████-███-██-██-██
-█-█-----█---█-█---█-------█---█-█-█---█-█---█-------█---█-----█---█-█---█-----█-█---█-------------█-
-█-███---█-█-███---█-███-███-█-█-██--█████-----█-███-███-█-█████████-█---█-███-█-███████-█-███-█████-
---█---█-█-█-█---█-█---█-█---█-█---█-------█-█---------█-█-------------------█-█---█---█-----█-----█-
-███-█████-█--██-█-███--█--███-████-█-██-█-█████-█-██-██-█-█-██████--███-█████-█-█---█████-████-████-
-█-------█-█---█-----█-█-----█-█-█---█---█---█---█---------█-------█---█-----------------█-----------
-█-███████-█-█-█-███-█████--████-███---███-█-█-█████-███--██---███-█-█-█-█-███-███-███-█████-█--████-
-█-----█-----█-█---█-----█---------------█---█---█-----█---█-█-----█-█-█-█-█-█---█-█-------------█---
-█---████--█-███-█--█-████-█---███-█-██████--█████-█-█-█-█-█-█-█-███████-███-███-███-█████-███████---
---█---█---█---█-█-----█-█-█-█-█-----------█-█---█---█-█---█---█-█---█-----------█-█-█---█-------█-█-
█-██-███-█-███-███-█-███-█-███-███-███-█-██-██---█-█-█-█-█-█████-█-█-███--████--██-█-█-████████-█-███
-----█---█-█-----█-------█---█-------------------█-█-█-█-█-----█-----█-----█---█-█-----█-----█-------
-█-█-██--█-█-█---███-█--████-█--██-█--██-█---██████████--█-█--██-██-█--█-█-███-█-█-█--██-█████-██--█-
-█-█-------█---█-█---█-----█-█-█---█---█---------█---------█---█-------█-----█---------█-----------█-
██-███-█-███-█████-█████-███-█------██-███-███████-█-█-███-█-███-█---█-█--██-██-█----█-█-█-█████-███-
-----█-█---█-█-----█-------█-█-█-█---█-█---------█-█-------█-█---█-█-█-█-█-------█-█-█---█-----█-----
██-███-█-████-██---█-█-█-███---███-█-█-█-█-███████-███---█-█████-█████----██-█-█-█-███-█-███████-█-██
-------█---█-----█---------█-█-----█-█-█-█---------█-----█-------█---█-█-█-------█-█---█---█-----█-█-
██-█-█-█-███-█---█-██--█████-█-█-█-█---█-█-█-███-█---██-████████-█-█-█████-█-█-███-█-█-███-█-███--██-
-----█-█-█---█-█-█-------█---█---█-----█---█-█-----------------█-----█---█---█-█---█-----█-------█---
-█████-███-█--██---█████-----███-███-█-█████-███-██--█-█--██████-███-█-█-███-█-█████-█-█████-█--██-█-
-█-█-----█-█-█-----█-----█-█-█-------█-----█-------█-█-█-------█---█-------█---------█-------------█-
-█-█-█████-█-█-█---██--█-█-█████-███-█--██-███-----█-█-█--████-████--█---███-███-█-█-█-███████-█-█--█
-----█-----█-█-█---█---█-----------█-█---█-----█-█-█---█-----█---█---█-█-█---█---------------█-█-█---
---█-█-█-███-█-█████-█-█-█-███████-███-███-███-█-█-███-███-██-█--██████--███-█-███-███-█---█-█-█████-
-█-█-█-█---█-█-----█-█---█-----------█-█-█---█-█-█-█-----█---█-----------█---█-█-----█-█-█-█-------█-
██-█-█████---███-███-█-█-█-█-█-█-█-█-██--█████-███████-███---█-██--█-███████--██-█-█████-█-█--██-█-██
---█---█-------█-█-------█-█---█-█-------█-----█-█-------█-------█-█-------█-----█-----█-█-----------
-█-█---███████████-█-█-█-█-███-█-█-█████---███-█---███---█-██-████-█---█████-█-███-█████--██-█████-██
-█-█-█---------------█---█-----█-------------█---█---█-█-█---------█-█-------█-------█-█-█-------█-█-
█--█████-█----██-█-███-███████-█-█-█-██-██-█-█--█-████-█-█-███-██--████--█-███████-█-█-███████-█████-
-------█-█-------█-█---------█-█-█-█-----█-█---█---█-█-█-█-------█-----------█---█-█-------█---------
-█-█-█--██-█-█---█-██--█-█-█-██-██-█-███-█-█-███-██--█████-██████-█-██--██-███---█---███-██-██-█████-
-█-█-█-█-----█-█-█-█---█-----------█---------------------█-----------█---█-█-█-█---█---█-----█-----█-
-███-█-███-█-██████--█---████-███--███-█-███-███-█-██████--█-█-█-█-███-███-█---█-███-███-█-████--████
-█---█-█-----█-------█-█-█---█-----█---█-█-█-█---------█---█-█-█-█---█---█---█-----█---█---█-█-█-----
-█-█---█████-█-███--████-█-███-█-███-█-█---█-█-█-███-█-█-██--█████-███-----█--██--██---███-█---██-██-
-█-█---█-----█-----█---------█---█---█-------█-------█-█-█-----█-█-█-█-█-█-----█-█---█-------------█-
-███████████-██-██-███-█-█-█-█-█---█-█-███-█-█-█-███-█-█-█-███-█-███-██-██--████-█-███-███-██████--██
-█-------------█-----█-█-█-█-----█-█-█---█-█-------█---█---█---------█-█-█---█---█-█-█-█---------█-█-
-█-█████-███-███-█-█---████-████-███-█----█--███-██-██-█████-███-█-███-█-█-█████████--██-█---█-█-█-█-
-█-█-----█-------█-█-█-------------█-█---█-----------█---█---█---█-█---█-█-█-█-----------█-------█---
-███-████-██-███-█---███-██--███-█-█--████---█-███████--██-█-█-█-███-█-█--██-███-█-█-█-█-███-█-██████
-█-------------█-█---█-----█-----█-█-----█---█-------█---█---█-█---------█-█-█-█-█-█-█---█---█-----█-
-█-█-███████-█-███-█-█-█---█-█████-█-█-█-█-███-██--███████████-█-███-█-███-█-█-█████-██--█-███-█-███-
---█-█-------------█-█-█---█-------█-█-█-█---█-------█-----█-------█-█-------------█-█---------█---█-
-███-█------██-███-█-█-█████-█-█--██-█-█-█████-█-█-███-█--██-███-█-███-----█-█-██--███-█-█-███-███---
-█-----█-█-█-█---█-----█-----█-----█-█-█-----█-█-█---------█-█---█-█-█-█-█-█-█-█-----█-█-----█-█-----
-█-███-█████-█-██--█████████-█-███-█-█-█-███-█-█-█-████████████----█-███-███-█--████-█-███-███--██-█-
---█---█-█-----█---------█---█---█-█-█-█-█-█-█---█-------█-------█---------█-----█-------█-█---█---█-
-█-█-███-█████-█-█-█████-█-█-█---█-█-█---█--█--█████-█-███--███---██---█████-█-█-███-███-█-███-███-█-
-█-----------------█-█---█-█-█---█-█-█-█---█-█---█---█---------█---█-------█-█---█-----█-█---█-█-----
-█-███-█-█--██-█-█-█-█-█-█-███-█-█-█-██--█-█-█-███-█-█-█-█-█-███---█-█-█-███-█-█-█████-███-█-███-███-
-█---█-█-█-█-----█---█-█---█-█-█-----█-------█---█---█-█-█-█---█-█---█-█---█-█-█-------█---█-█-------
███--█---█-███-█-███-███-----█-█-███████-█-███--███--█-███---█-█████---█-███-███-█-█████---███-█-█-██
-█---█---█---█-█-█-----█-█-█---█---█-█---█-----█-----█---█-█-█-----█-█-█---█-█---------█-█-----█-█---
--██---█-█-████-█--█-████--█-█-█-█-█-█-█-█---█████---█████-█----██-█-█-█-█-██--█-█--██-██-████-█-█-██
-----█-█-█-----█---█-----█-█---█-█-----█-█-█---█---█-------█---█---█---█-█-----█---█---------█-█-█-█-
-███-█-█████-███-█---████-██-█--██-█-█-███-███████-███-███-█-█████-█-█-█-█-█-███-█████-███-█-█-█-█-█-
-------------█-----█---█-█-------█---█---------█---█-----█-█---█-----█---█---█-------█-█---█-█---█---
█-██-█-█████████-███-███-███-█████-████--███---█████-██--█-█---█-█-█--██-███---█--██-█-█--██-█-█-█-██
-----█-------█---█-----█-█-█-----█---█-----█-█-----█---█-█-█-█-█-█-█-------█-█-█---█-█---█-█---█-----
-█-█---█-███████-██--███-█-█-█████--████-███-██████-██████-███████-███-█-█████-█-█-█-███-█-█---█-█-█-
---█-█-█---█-█-------█-█---------█-----█-█-----------█-█---------█-------------█-█-█-█-----█-█---█-█-
-█---███████-█-█████-█-██--█-█-███-█-█-███-█--██-█-█-█-██--█-██-██-█--██-█-█████-███-----███-█-█-████
-█-------------█-------█---█---█---█-----█-█---█---█-----█-█-----█-█-█---█-----█---█---█-█-█---█-----
██-█-█-█████-██-█--███-█████-███-███-█-█-█-█████-█---█---█----██---███-███--████-█████-█-█-█-█-█-████
---█-█-█-------------█---------------█-----█-------█-█-█---█-█---█-█-------█---------█-----█---------
██-█-█-█-███-█-█---███-█-█████-██-██-█-███-█████-███████---█-█-█-█-█-█---█████-███████-███████-█-█-█-
---█-█-------█-█-█-█---█-█---------█-█-█---█-----█---------█-█-█-█-█-█-█-------█---------█-----█-█---
-█-█-█-███-███-███---█-█-█-█-█-█--███---█--█████-█---███-███████████-█-█-███-█--██-███-███████-█-█-██
-█---█-█---█---█-----█-█-█-█---█-------█---█-------█---█---------------█-----█-█-----------█---█-█---
-█-█████---█-███-█-█-██-██-███-█-███-█-██-█--█-█-█-█-█-███-█████████-███-█-█-█-██--█-████--█████-█-█-
-█---█---█-----█-█---------█-------█-█-█-----█-█---█-----█---------█---█-----█-----█-------█-----█-█-
██--███--███-███-█████-█████████-█-███-█-█████-██--█-█-█---███-███-██---████-█████---█-█--██---█---██
-----█-█-█-----█-█-----█---------█-----█-█-----█---█-█---█-------█---------█-█---█-█-------█-█---█---
██-███-█-█████-█-█-█-█-█-█-██----███-████████--███---█-█-█-███-█-█-█-█-███--██-███-███-█-█-█████-█-██
---------█-------█-█-█-█-█---█-█---------█-------█-█-█---█-█---█---█----------------G█-█-█-------█---
100 84