A----█---------------------█---█-----█-------------------█-█-█-█-█-█-█-█-█---█-█-----█-----█-█-------
-█-███-███-██-████-██-██--██--██-█-███-█--██-██-██-███-███-█-------█-█---█-███-█-█-██--█-█-█-█-███-██
-█-------█-█-█-█-------------█---█-----█-------█-█-------█---█-----█-█-----█-█-------█-█-█---█-----█-
-█-██████--█-█-█-█████--██---█-███-███-█████████-███-█--████-███-██--█-█████-█-█-█-███-███-█---█-███-
-█-------------------█---█-█-█---█-█-----█---█-█-----█-----█---█-█-█---█---█-█-█-----█---█-█---------
-█-█████---██--███-██-██████-█-██--█-███---███-█████-█-█████---█-█-█-███-█-█-█-█-█████-█-█-███-█-█-██
-----█-█-█-█-----█---------------█-----█-------█-----█---█-█-█---█-------█-█-----------------█---█---
-█████--█-██-█-█-█-█-█-████--█---█-███████-█████-███---███-█-███-█-█-███-███-██████████--██████-██-█-
---------█-█-█-█---█-----------------------------------█-█-█-█-█-------------------█---█-█-------█-█-
-██--█-█-█-██--██████████-█--█-█████-███████████-███---█-█-█-█-█-█████-███-██--█-███-█████-█-███-████
---█-█-█---█-------█-------█-█---█-------█-█-█---------------------█-------█-----█-----█-----█-█-----
-█-█-███-█-███--██---█████-███-██████████--█-███-█-█████-█-█-███---████-██-███-███-█-███---██--█-████
-█-█---█-█-█-----------█-█---█-----█-----█---█-█-█-----█-█-█---█-█-----------█-----█-----█-----------
-███-█-█-█---█-████----█-███-███████-█-███-█-█-█-█-█-█-███-█████-███-███████████████-█-█-███-█-██████
---█-█---█-█---█-----█---------------------█-█-█-█-█-█-█-------█---█---------------█-█-█-----█-█-█-█-
██████-██--█████-█-█-█████--██-███-█-███-█--██-██-███--█-█-███-███-█-██--█-███-█-█████---███--██---█-
---------█-█-----█-█-█-█-█-█-█-------█---█-----------█---█---█---█-------█---█-----█-█-█-█-█---------
██-███-█-█-███-█---███-█-█-█-█--██-█████████-███-█-█-█-█-█---███-██████-████--█--██--█-██--█-█-█-████
-----█-█-█-█-----█-------█-------█---------█---█-█---█-█-█-█---█---█-█-█---█---█-█-█-------█-█-------
████-█████-███--█--█-█-███-███████-███-█-█-█-███-█████████-███-█-█-█-█-█-██--█-█-█-█-█-█-████--█-█-██
---------█---█-----█-----------------█-----█-----------█---█-------------------█---------------█-█---
--██-█-█-█-█████-█-█-███--████-█-██--█-█████-█-█-███---█████-█--██-█-██--█-█████-█-███████-█-███--██-
---█-----█-█-█---█-█-------█---█---█-█-----█-█-█---█-█---------█---█-█---█-█---█-█-------------█-█---
-█-███-█-█-█-███████-█---█---█--████-█████-█-███-█████-██---██-█-█-█-███-█████-█████-███████-███-█-██
---█-----█---------█-█-█-█-------█-------█-█-█-----------█-█-------█---█---------------█-█-█---█-----
-█-███-██--███-█-█-███--███--█-█████-█-███-█████-███-████--███-█-███-█-█-█-█████████-███-█-█-███-████
-█-█-----█---█-█---█-█-------------█-█---------█---█-█-█---█-█-█-------█-█-------█-█-----█-█---------
██-███-█████-█-███-█-█-█-███-█-█--███---██████-███-███-███-█-█-█-████-█-██-----█-█--██-█-█-███████-██
-█-------█---█-█-------█---█---█---█---------█-█---------------█-------------█-█-----█-----█-----█---
-█-█--███-██--██████-█-█-█-█-█-███-█-█-███-████--██-██-███████-███-███-█-█████-███--██████-█-█-█-█-█-
---------█-█---█-------█-█-█-█-█---------█---------█-█-------█---█---█-█-█-------█-------█-------█-█-
██-█-█-███-█-█-█-███-█-███--██-███████-█-█-█-█-███---█---███-███-█████-█████-█-███-█-█-█-█████████-██
---█-█-----█-█-█-█---█-------------█-------------█-█---█-█---█-----█-------█-█---█---█-█---------█---
████-█-█-█-███-█---█-███-███-███-█-█████-███-███-████████-██-██████--███-█---█---█---█████--██-███-██
-█---█---█---█-█-█---█-----------█-----█-█-----------------------------█-█-█---█---█-█-----█-█-----█-
---██-██-█-█-█-█-█-█-███-█--████-███-██--███-██--█-██-█████--██--████████-████████-█---███-█-███-█-█-
-----█---█-█-█---█---█-------█-------█-----█-█-█-█---------█---█---------------█---█-█---------█-█---
-███-███-█-█-█-█-█-█-█-█----██████-█-███-██--█-██--███---███-███-███-███-█-█████-███-█████-█-█-████-█
-█-----█---█-----█-█-----█---------█-█-█-█-------------█-█-█---█---█---█-█---------█-----█-█-█-------
-███-███-███---█-█-█--██---█-██-█-████-██-█--█-----███-█-█-███-█-███-█-███-█████████████████-███-█-██
-----█---█---█---█-█-----█-█---------------█-----█-█---█-------█-█---█---█-----█-█---------█---█-█---
████-█-█████-█-█████-█████-█-███---█-█████-███-███---███-███-███████-█-███-█-███-█-██████████-████-██
---█-█-█-----█-----------█-█-------█---█---------█-█-------█---------█---█-█-------------------█-█---
---█---█-█-█████--██████-███-███-███--█-████-██-████-███--██-█---█-█-███--████-█--██-█████-█████---█-
-█---█-------█---█-------------█---█---------█---█---█-----█-█-█---█-█-----█---█---█-█---█-█-█-----█-
█--█-█-███-█-█-█--████-█-█-----█---█-███-█-█-█-██--█-█-█-█-█████-███-███-█-█-███-█-█-█-█-█-█-█-██--█-
---█-█-█---█-█-█-------█-█-█-█-█-█-█---█-█-█-------█-█-█-█-----█-------█-█-█---█---█-----█-█---█-█-█-
-█-█-██-█--███-█-██-██-█-█-███-█-███-█---█-█-███-█-███-█-██--█-█-█----████-██---█████--███-█-███-████
-█-█-█---█-█---█---█-------█---█-█---█-█-█-█-█---------█---█-----█-------█-█-----------------█-----█-
-█-█-█-██----█-█-██-██-███-█-███████-███-█-█-█-█---█-█████-█-█████-███-█████-█-█-███-██--█-█-█-█--██-
-------█---█-█---█---------█-------█-█-█-█-----█-█-█-------█-----█---█-█-█-----█-------█-█-----█-█---
-█-█-█████-███-█████-██-████--██-█████-█████--██-█-█-█-█-█████-████-██---█████-███████-██----██-█--██
-█-█-----█-█-----------█-█-----█-----------█-----█-█-█-█-----█-----------█-------█---█---█-----█-█---
-█-█-█-█-█-█-█-█-█-█-███-█-███████--████-█-███-█-█---█-█---███-█-████████---██---█-███-█████---█-█---
-█-█-█-█-----█---█-█-----█-------█-----█-█---█-█-█-█---█-█-------------------█-█-----█---█---█-------
---█---███-█-█-█-███--██-█-█-█-█--██-█-█-███████-█-█-█-█-█-█---█████████-█-█-█-█████-█-███████-█-██--
-----█-█---█-█-█-█---------█-█---------█-----█-█---█---█-█---------------█---█-----█-█-----█---█-----
-█████-█-███-█-█-█-█-█-█████---█-█-█-███-███---█-█-█--██-█-█--█-█-██████-███-███-███-███-██-██-██--█-
-----█-█-█---█---█-█-█-█-----█-----█---------█---█-█---█-█-█-█-█---█-------█---█---█---█-----█---█-█-
-█-█-█-█-█-██--█---██--████--█-█--██-█████-█████-██--█-███-█---█-█-█---█████-███-█████-█████-█████-█-
-█-█-█-█-█-█-----█-█---█-█-█-█-█---█---------█-----█-----█-█-----------█---█-----█-----------█-------
-███-█-█-█-█-█-█-█-█-██--█-█-███-███-█-███-███████-█████-█-███---██-██-█---█-█████---███-█-███-███--█
-----█-█---█---█-█---█---------█-█-█-█-------█-█-█-█---------█-----█-----█-------------█-------█-----
-███-██----███-███-█████-█-█-███-█-█████--████-█-█-█--██-█-███-█-█-█-███-████-██---█-██-█-█-██-██-██-
-----█-----█-█---█-█-----█-█---█---█---█---------█---█-█-█---█-█-------------█-------█---█-█---█---█-
-█-██--████--█-██--████-██-█-█---███-███-█████-██████--█-█-███--██-█---███-█---█████-█--██-█-█████-██
-█-----█-------█---█-------█-█-----------█-█---█-█-----█-█---█---█-█-█-----█-----█-█-█-█-------█-----
-█████-███-███-█-███████-█-███-█-█-███-██--████--█---███-███-█████-█-███-███---███-█-█-███-██-██-██--
---█-----█-------█-------█-------█-█-----------------█---------█---█-█---------█---------------------
---███-███---██--███-█--██████-█--██████████-████-█--█-█-█-███████-█-█-███-█-███-█-█-------███-███-██
-█---█-----█-█-----█---█-------█-----------█-█-----█-█-----------█-█-█-█---█-----█-█-█-█-█-█-█---█---
-█-██--█-███-█---█-███-█---███-█-█-███-█--██████-██--█████-██--███-█-███-█-█-█-█-███-███████-█-█-█-█-
-█-█-█-----█-█---█-█---█---█-█-█-----█-----█-█-----------█-█---------█-----█-█-█-█-------█---█-█-█---
-█-█-███-█-█-█-█-██-██-█-███-█---█-█--██-█-█-█--██--█-██-█-█-█--██-█--██-███-█████-███-██--█-███-███-
-------█-------█-█---█-█---█---█-█---█---█-█-------------█---█---█---█-----█-----------█---█-----█---
-█-█-███--██-██-██-█-█-███████-█████-███-███-███-█████-███-█-█---██--█-█-█-█---███--████-██--█-████--
-█-█-----█---█-----------------█-█-------------█-----█---█-█---█-----█-█-█-█-█-█-------------█-----█-
██---█-█-███-█████--███--███-█-█-█████-█-█-█-███-███-█-█-█████-███-█████-███-███-█--██--██--█--█-█-█-
---█-█-█---█-█-----------------------█-█-█-█-█-----█-█-█---------█---█-------█-█-█---█---█---█---█---
-█-█-█-█-█-███-█-█-█-███-█-█-███-█████-█---█████-██████-██---█-█-----█-█-███---█-█████-██-███████████
-█---█-█-█-----█---█-----█-------█-----█---█---█---------█-█-█-█-----█-█---█-█-----█-----------█-----
-█-███-█-█-███-█-█---██--█-██-██████-████--█--██-█████████-█-█-█████████-█-█-█-█-█-█-█████-██-██-███-
-----█---█-------█-█-█---█---------█-----█-█-█-█---------█-█-----█---█-----------█-------█---------█-
██-█████----███-██--██-█████-███-███-█-█-█-█-█-███-█-█-███-██-██-█-█-███--██-█-█████-███████-████████
-----█---█-█-------█---------█-----█-█---█-------█-█-█-------█-----█-------█-█---█-█-----█-----------
██-█████-████-██---█-█---███-███-███-█-███-█-███-█-█-█-█-█-███-█-█-█-█-█-█████████-█-█-██-██-█-█-█-██
-------█-█---------█-----█---------█-█-----█-█-█-█-----█-█---█-█-█-█-█-█-----------█---------█-█-----
-█-█-█-█-█-██--█-████-██████-----██--█-███-███-████-█--██-████-███-███-███-█-█████-█-█-█-███-█-███-██
-█---█-█---█---█---█---------█-----█-█-█-------█-------------------█-█-█---█-----█-█-█-█---█-█---█---
█--██-████-█-█-█---█████--█--█-██----███-█---█---█-████--█-█-███--██---█-█-███-█████-█-█████████-█-█-
-----------█-█-█---------█---█-█---█-█---█---█---█-----█-█-█-█-------█---------------█-----------█-█-
-█---█--████-█-█-█-█████-█████--██████--██-██--█--██-█-█████-█-█-█-███████-█--████--█████-█-████-████
-█-█-█-█-----█-█-█-█-------█---█-█-----█-----█-█---█-█---------█-█---------█-----█---------█---------
-█-█-█--███----██--███-███-█████-█████-███--████-███-█-█-██---██-█-█-█████-█-█-███-████-█--█-█-███-██
---█---█-----█---█---█---█-------------█-------█---█---█---█---█-█-█-------█---█---------█-█-█-------
██-█---█-█-█-██--██████--█████████-█████-█-█-████--███████-█-█-█-█-█---█-███-███-█-█-████-█--█-███---
---█-█G█-█-----------█-----█-------█-█---█-█-----█---------█-█-█-█---█-------█---█-█-------------█-█-
█----███-███-█-█████████-█-██--███-█-█-█-█--██-███-█-██--███████-█-███-███-█--██-███---█-█---█-█-█-██
-----█---█---█-----█-█---█-----█-----█-█-█-------█-----█-------█-█---█---█---█-█---█---█-█---█---█---
█-██-███████-█-████--███-█-█---█----████-█-██-██---█-███-█--████-█--██-█-█████-███-███-█-█-█-█-██----
-----█-------█-------█-----█-█---█-█-----█-----█---█---█-█-----------█-----------█-------█---█---█---
96 6