A--█---█-█-------------█-█---█-█-█-----█-█---------█-----█---------█-█-----------------█---█---------
--████-█-█-█-█████---██--█-█-█-█-█-█████-█-█-██--███-█████-██-██-█---█-███-██-█-██-██--█-██----███-██
-----------------█-█-----█---█-█---█---█-█---█-----█-----------█-█-------█-------█---█-█-------█-----
-█-█-█-████--█-█████-█-█---███-█-█-█-██--█-███-█--██-█-█-█-███████-█-███-███-█-████--███-███-█-█-███-
---█-█-----█-█---------█---------------█-----█---█---█-----------█---█---█---█-----█-------█-█-----█-
██-██████----█-█-█-█-████-██---█-███-█-█-████--█-█-████--███--█████--███-█---█████████-█████-██-██-█-
-----------█-█-█-----------█-█-█-█---------------------█-█---------█-█-█---█-█-█---█-----█---█-█---█-
-█--████-█-███████-█-█-█-███████-██--█----██-███-███████-█-███-█████-█-█-█--██-█-███-█-██--██--█-███-
-█---█-----█-█---------█-------█---█-█-█-█-█---█---------█-█---█-----█-----------█-----█---█-█-----█-
-█-████--███-█-███-███-█-███-█-█-██---██-█--███-██-█-███-███-█-█-█████-███████-███-█████-----█-█████-
---------------------█-█-------█---█---█-------█-█-█---█---█-█---------█-------█---------█-----------
-█-███-█-███-█-█-█-████--█-█-█-█---█-█████-██-██-█-███-███-█-██--█-█-█-█-███---█-█████-█-█████-███-█-
---█-█-█---█-█-█-------█-█---█-█-----█-----------█---█-------█---█---█-█---█-█-█-█-█---------█---█-█-
█----█---█-█-█-██████--█---█-███-███-███-█████-█-█████---█████-█-█-█-█-█-█-█████-█---███-█-█-█--██-██
-----█-█-█-----------█-█-█-█---█-------█---█---█-----█-█-------█-█-█-------█-----------█---------█---
████-█-███-███-█---█████████---█-██-███--██-██-█████-███-███-█-█-████-██-█-█-█-█-███-█-███████-████--
-----█-------█-█-█-----█-----█-█-------------------█-█-------█-█-█-----█-█---█-█-----█-----█-█-------
-----████████-███-█--█-███-█-██-██-█-█-█-██-██-███-███-█-----███-█-█-████--█-█--██-█-████-██-█████-██
-█-█-------------------█-█-█-----█-█---█-█-█-------------------█-------------█---█-----█-------------
-███-███████-█████-███-█-█-█-████-██-█████-█-█-██████--██--███--██-█-█-█-█---█-█████-█████-██----███-
-----------█-█---█-█-------█-----------█-------█-█---█---█-█-------█---█-█-█-----█-█-█---█---█-█-----
-█-█-███-█-███-███████-███-█---███████-█-█-█--██-█-██--█████-█-████-████-███-█-█-█-█████-█-██████--█-
-█-█-█-█-------█---█---█-█-█-█-----------█-█-█---█---------█-█---------█-█---█-█---█-█-█---------█-█-
██-█-█-█-█-█-█-█-███-█-█---█-█████-████--███--█--█-█-██--██---██-███-█--██████-█████-█-█-█-██████-███
---█-----█-------█-█-----█-------█---█-█-----█-█---█-----█---█-█-----█-------█-------█---█---█-█---█-
██-█-█-█-███████---█-█--██-████-██-███-█-███-█-█-██--███-█████-█-█-█-████--███-█-█-███-███-██--█---█-
-█-█-█-█-------█---------------█-------------------█---█-------█-█-█-----█-█-█-█-----------█-█-------
-█-█-█-█-█-█-███-█-█-████-███████████-████-█-███-█-███-█████████████████-███-█-██-██-█-█--██-█-█-█-██
-----█-█-█-█---█-█-█-------█---█-------█---█---█-------█-----█---█-█-█---█-----█-█-█-----█-█-█-------
-█-█-████--█████-█-█-█-███-███-███-█--██----██-██-██████-██--█-███---█-███-████----█-█-███-█-█-███--█
-█-----------█---------█-█---------█---█-█-█-----------█-█-█---█---------------------------------█-█-
████-█-███████-█-███-█-█-███-█-█-█-█-█-███-█-█-█-█-█-█-█-█-█████-█████-█-█-█████--███████████--█-███-
-------------█-█---█-█---------█---█-----█-----█-█-------------------█---█-█---█-------█-------█-█---
-█-███-█-██-████-█-█-█---██-█-████--█---██-█-█-█-███-████-██-█-██████-█----█-█-███--█-█-██-███-███-█-
-█---█-█-----------█-█-----█-----█---█---█-█-█-------█-------█-----█-█---█---█---------------------█-
██-███-█-█-██-████-█-███-███-█-███-█-█-█████-█-█-██-██-█████-███-█-█-███-██-██████-███---███-█-█-█-█-
---█---█-█-------█-█-----------█---█-█-█-----█-█-------█---█-----------█-------█-----█-█-█-----█-█-█-
██-███████-------█-█-██-██-███-█-█---█---█---█-█-█-█-███---███-████████-██--██████-█-██--██████████--
-------------█-█-█-----------█-█-█-█-█-█-█-█-█-█-█-█-------█---------█---------█---█---------------█-
██-█-███████-███████-█-█-█████-███-█-█████████-█--██----███--█-███-█████--██--██-██-██████-█---██████
-------█-------------█-----█---------------█---------------█-█---█-----█-█-█---█---------█-█-█---█---
██-███-██-████-█-█████-█-█-███-██-██-█-██--███████-██--██--██-██-█-███-█----██-█---█-█-█-█-████████--
-----█---█-█-----█-█---█-█-----------█---█-----█-------█-----█---█---█-----------█-█-█---█-█---------
-█-----███-█-███---█-█-██-██-█-█---████-██-█-█---█-█--██-█-███████-█████-█-█-█-███-█--████-███-███---
-█-█-█-----█-█-----█-█-----█-█-█-█---------█-█-█---█---█-------█---█---█-█---█-------█-█---------█-█-
█----█---█-█-███-█-█████-███-█-█-█-█-██--███-███-█--██-█-██--███---█-██-████-█-█-█-██--█-█--████-████
-----█-█-█-█---█-------█-█-----█-█-█---------█-█-█---█-█-█---█---█---------█-█-█-█-█-█---------------
-█-█-██████--█-█████-█-----█-█-█-█---█-██-████-█-█-█-█--█--█-█-█-██--███-███-█-█-███-█-█-█████-█-███-
-█-█---------█-█-█---█---█-█-█---█-----█-█-█-█-█-█-█-------█-█-----█-------█-█---█-----█-█-----█---█-
████-███-█---█-█-----█-█████-███-███-██--█-█-█-█-█-█-██████--██--██--██-██-███---█-███--██-███-███-█-
-----█---█-█-█---█---█-█-------█---█---------------█-----------█---█-------█-----█-█-----█---█---█-█-
-----█---█-███-██-████-████-██-█-███-█-███-█-█-█-██-████-███████-███-█-█████--██-█-█-█-█-█-███-██-██-
-█---█-█-█---█-----█---------█---█---█-█-----█-------█-------█-█---█---█---------------------█---█---
██-█-███-█-███-█-█-█-----█-█-███---█-█---█-███---█-█████-█-█-█-█-███-██-██-███-█-████-████-███████-█-
---█-█---█---█-█-█-█-█-█-█-----█-█-█-█-█-█---█-█-█-----█-█---█---█-█---█-█-█---█-------█-█-█-----█-█-
████---███-█-█████----██---█-█---█-█-█-███████-███-███-█--██-███-█-█████-██-█--█-███---█-█-█--██---█-
-----█-----█-------█---█-█---█---█-█-█---------------█-█-------█---------------█---█-------█---█---█-
██-█-█████-█--██████-█-███-█-█-█--██-█-█-█████-█████-██████-█----█-█-██-████-█-█-███-█--██---█---█-█-
---█---------------█-█---█-█-█-█-█-█-█-█-----█-----█-█-█-█-█---█-█-----█-----█-█-----█---█-------█---
██-█-█-█████--██-█████-██-████--██---███████-█-███---█-█-█-███-█-█-█████-█-███-███-█████-█████████-█-
---█-------█---------█-█-------█-----------█---------------█-█-----█-█---█-█-█-█-------------------█-
██-█-█-█--██-███-█-█████-█-███-█-█-█-██--████████--█-█-██-██-██--█-█-███-█-█-███-███-█-███████-██-███
---█-█-█-█-----█-█-----█---█-----█-----█---------█-█-█---█-----█-█---█-█-█---█-█-█-------------------
---███-█-███---███---███████-█████---█-█-█--██-█-█-████--█-█-██--█████-█-█-███-█-█████-█-█-█-█-█-███-
-█---█-----█-█-█---█-█---█-------█-------█-█-█-█-█---------█-█---------█---█-------------█-█-█---█---
████---█████---█-█-█-█-██████--█████-█---███-█-█-██--█--██-█-█-█-███-█---█-████--███-█-██--█-█-█-█-█-
-█-----█---------█-█-----█---------█---------█-█---█-█-█---█-█---█---█-█-█-█-----█-------█-█-█---█---
-█-█-█-█-█-█-███-███-███--█--█-█-███-██-██-█-█--██████-█-███-█--████--██-█--██-███-███-███-███-████-█
---█-█-----█-█-█-------█---█-█-█-█-------█-█-█-----█---------█---------------█-█---------█-----------
██-█████-█-███-█-█--█--█-████-██████-█-█-█-█████--████-███████-█████-█-█-█-█-███-█-███--███-██---█-██
-----█---------█-█-----------█-------█-█-█-----█-█-█-----█-█-█---█---█-█---█-█---█-█-----------█-----
██---█████-███-███-██--██-██-█-█████-█████-█-█████-█████-█-█-██████--███████-███-█████--████--██-████
---█-█---------█-------█-█-------------█---█-█---█-█-----█---------------█-----█-█-----------█-------
█--███-███-█████-█-█-█-█-█-█-███-██-████████---███--██-█-█-█-█-███-█-█-█████-███-█---█-█-█-███-█-█-█-
---█-█---------█-----------█---█-----------█-------█---█-----█-█-----█-------█-----█---------█-----█-
-███---█-███--██████-█-█-██--█-█-█-██-██---███-█-███-█-█████-███-██-██--██-█-█-██--█--█-██-██--█-███-
-█---█-█-█---█---------█-█---█---█-----█-█-------------------------█-█-----█-█---█-█---------█-█-----
--██-█---███-█-█-█-█-███-█████---██----█-█-█-███-█-█-███-█-███-█-██--██--█--█--███-██--███-██--█-██--
-█-----------█-█-█-█---█---█---█---█-█-█-------█-█-------█-█-█-█-█-----█-█-█-----█-█-----█---█---█---
-████--█---█-█-█-███--██-█-███-█-██--██████-██-███-█-█---███-███-███-█████████--██-███-███-█-█-██████
---█---█-█---█-█-█-----█-------█---█-----█-█-----█---█-------█---█---█-█---█-----█---█---█-█---█-----
-█---███-███-█-██--███-█-█--████-█████-█-█-██--█-███-█-███-███████-█-█--██-█-█--█-█--█---█-█-███--██-
-------█-█---█-█---█---█-█-------█---█-█-█---------█---█-█---█---█-█-█---█---█-----█-█-█---█---------
-███---█--██-█-██--█████-█-█████-█-█-█-█-███-█-███-███-█-█-███-█-█-███-███-███-█-█-█-█-██--█████-████
-----█-█-█---█-█-█---█-------█-----█---█-█-------█---█---█-----█---█-----█-█-█-----█---█-------█-----
--██-█---█████-█-█-█-███-█-█-█████-█-█████████-███-█--████-█-██--█-█-█-█-███-███-█-█-███████-███-██-█
---█-█-█-█-------█---█-----█---█-------█-█---------------█-----------------█---█-█-█---█-----█-------
-████-████--██-███████-█-█-███████-█-███-█--██-███-█--████-███-█---███-█████-█-██--█-███-█-███--██--█
-------█---█---█---█-----█---█-█---█-----█---█-█---█-----█-█-█---█-----------█---█-█-█-█-█---█-█-----
-█-█████████--████--██-█---███--██-█-█-█-█-----█-█-█-█-███-█-█--█-██-███---█-█-██--███-█-███-███-██--
-█---█-----------------█-█---------█-█-█---█-█-█-█---█-------------█-█---█-█-----█-------█-█-█-----█G
-███-███████-███-█-█-███-█-█-█-█-████--███-███████-█-█-███-████--███████---█-█-█████-█---█-██--█-█-█-
-█-----█-------█---█-----█-█-█-█-█-------█-----█-----█---█-----------█-----█-----█---█-█-----█---█---
-█-█-█---█-████--█-█-█-█-█-███-████-██-█-█-█-███-███-█-█████-█---█-███---█-█-███-█-█-█-█-█-██--███-█-
-█-█---█-█-█-----█-█-█-█-█---█---█-------█-----█---█-----█-----█-█---█---█---------█-█---█-█-█-------
████-███-█-█---█-███-█-█████-███--██-----███--██-█-███--██-███-█-█-█-█-█-███-███-█-█-███-███-█-██████
-------█-█-█-█---█---█-----------█-------█-█---█---█---------█-█-█-█-█-█-█---█---█-█-------------█-█-
-█-█-███-█-█-█-█-█████-█-█-██--███-█-█--██---█-█-█-█-█-█-███-█████████-█████-█-███-█-█-███████-███-█-
-█-█---█-█-█-█-█-█-----█-█---█---█-█-█-------█-█-█-█-█-----------█-█-█-----█-----█---------█---------
██-█-███-███-███████-█-███████-██████--███-███-██-██--██-███--██---█-█-█-███████-███-█-█---█-███-████
---█-█-----------█-----------█-----█---------█---------█-█-----█-----█-█-█---------█-█-----█---█-----
90 100