A----------█-------█-█-█-█---------█-█-------------------------------█-----█-█-█-█---█---------------
---██--█-███-█-█-███-█-█---███████---█--██████-███████-█-███-█-█-█-█-█---██--█-█-███-█--██-██-█--███-
-█---█---█-█---------------------------█-----------█-█-█---█-█---█---█---█-█-----------█-█-█---█-----
-███-█-███---█---███--██-█-█-█████--████-█-█-███████-██-██--██--██-█-█-██--█-███---█████--██-█-█████-
---█---------█-----█---█---█---------------█-█-█-█-------█-█---█-█-█-----█-----█-█-█-------█-█-█-█-█-
-█-----███---█████-█-███-███-████-████-█-█-███-█-█-█--██████-█-█-██--█████-███████████-██--█-██--█-██
---█-█---█-█-█-█-█-█-█---------█---------█---------█---█-----█-█-------█-----------█---------█-----█-
--██████-█-█-█-█-█-█████-█-█-█-█-█-█████-█-█-███████-███-█████-███-███-███-███-███████-█-██-████-██--
-----█---█-█-----█-----█-█-█-█---█-█-█-█-█-█-█-█---█-------█---█---█---------█-----------------------
-█-██----███--██-███████-██-██--██-█---███---█-█-█-█-███-█████-█-██--█---██-██-█-████-██-█---███-█-██
-█-█-█-█-------█-----█-------█---------█---█---█---█-█-----█-█-█-----█-█-------█-█-█-█-----█---█-█---
-███-███-█-█-█-█-█-█-█-█---█---█--█---██-███-█-█--████-█-███-█-█-█████-█-██████-██-█-███-█-█-████-███
-------█-█-█---█-█---█---█-█-█-█-----------█-█-------█---█-----█-----█-█---█-------------█-█---------
██--█--███-███-███-█-█████-█-███-█-██--███████--█--███-██--█████-██--███-█-█--███---███-██-████████-█
-----█-█---█-█-█-█-█---█---█-█-█-----█-█-----█-█-----█---█-█-█-█-█-█-----█-█-█-█-█-------█---█---█---
---███-█--██-███-█-█████-█-███-████--█-█-█--██████-█-█-███-█-------█-█-█████-█---█-███-███-██--███-██
-█---█-█---█-----█-█-█-█-----------█-█-----█-------█-█-█-------------█-----------█---█-----------█-█-
-█-█-███---█-███---█-█-███-███-█████-█-█████-█████-█-█-█-████-██-█████-███-█-█-█-█-█-█---█-█-███-█-█-
-█-█-█-------█-█-------█-------------------█-█-█---------------█-------█-█---█---------█-█-----█---█-
-███---███-█-█-███-█--████-█████-███-███-██--█-█-█-███---█--██-███-█████-███-█-█-█████-███████-█████-
-█---█-█-█-█-----█-█-----█---█-----█---█-█-----█-----█---█---█-█-------█-----█-█-█-█-█-------------█-
-█-█-█---█---██-████-██----█-███-█-█-█-███-███-█-████-█--███████████-███---█-█-███---█████████-█-███-
-█-█-------█-----------█-█-█---█-█---█-------█-------█-----█---█---------█---█---█-------------█---█-
-████--███-█-█---█-█-███-██████--██--█-█████-█---████-█----█-█-█████-██--█████████-██-████████-█-███-
-----█-█-█-█---█-----█-------------█-█---█---█-█-------█-█-------█-█---█-----█---------█---█---█-----
-█---███-█-███---███████-█-█████-█-███-██-█-██████-█-█-███-█--███--█---████-██-█████-███-██--█-█-█-█-
-█-█-------█---------------------█-█-----------█-█-█-█-----█-------█-█-█-----------█-----█---------█-
-███-███-█---█-█-██--█-█-█--████-█-█---█-███--██-██--█--█-█-████-█-█-██--█-██████--███-███-█████-█-██
-█---------█-█-█-█---█---------█-█-█-█-█-█---------█-█-----█-------█-------------█-----------█-█---█-
-█---█████-█████-█-█---█-██--█████---████-██-█-█-█-█-█-███-----█--█--███---███-█-███-█---█-█-█-█-███-
-█-█-----------█---█-█-█-----█-----█---█-----█---█-█-█-█-----█-█-------█-----█-█---█-█-█---█---█-----
-██-████-█-██---████-█-█-█-███-████████--█-█-███-█-████-██---█---█-█████-█-█-█-██--███-███-███████-██
-█-█---█-----------█-█-█-█-----█---█---█-█-█-█-█-------█---█-█-█-█-----█-█-█---█-█-█---█-------█-----
---█-█-█-█---█-█████--███-████-███-█-███--██-█-█████--█-██-█████-█████---█-█████-██-██-█-███-█-█-███-
-----█-------█---------█-----█-------█-█-█---------------█-----█-----█---█---█-█-----█-------█-█---█-
-█████-███-███-█████-███-█-███-███-███--██-█--█--███-█-█-███-███-███-██--█-███-█-███-█-█-█-███-█-█--█
---------█-█-------------█---█-█---------█-█---█-█---█-█-█-█---------------█-█---█-█-█-█-█---█---█---
██-█--██-█-█-█--██-███-█-███-████--█-█-█-█-███-█-█--█-████-█---█-██----█████-█-█---█████-█-███-██--█-
---█-█-█-█-█-█-----█-----█-----█---█-█-█---█---█-------------█-█-----█---█-----█-------█-█---█---█-█-
██-███---███-█-████-██-███---███--██--████-███-█-█-███-█-███-█-█--██-█-█-█-█-█-███-██████--███-██████
-█-█-----█---█-----------█---------------█---█-█-█---█-█---█---█-------█-------█-█-█---█-█-█-█-----█-
-█-█████-███-███████-█-█-███████-███-█-█-███-█████--█--█--██-█-█-███--████-█████-███-█-█-█-█-██--███-
---█-█-----█-----█---█-█-------█---█-█-█-█-█---█-----█-█-█-█-----█-------█---█---█---█---█-----█-█---
-███-█-█-███-███████-███-█████-█-█-█---█-█-██-█--███-█-█-█-█--██████-███████-█-█-███-███-█--████----█
-█-█-------------█---█-█-----█-█---█-█---------█---█-█-█-----█---█---------█-------█-█---█-█-----█---
██--██-█-███-███-█---█--█████--█-█████-█-█--██-█---█-███-█-███-██-██████-█---█-█-███---█████████-█-██
-------█-█-----█-█-----█-█-█-█-█-█-----█-█-----█---█---█-█-----------█---█-█-█---------------------█-
██-███---███-█-█-███--██-█-█----██-█-█-█-█----██-█████████-█-█-█████████████-█-█---███--████-█-█-██--
-----█-----█-█-█-█-------------------█-█---█-█-█---------█-█-█---------█-----█-█-█-█---------█-█-----
██-███-██████--███-███-█████-█-█-█-█---█-█-█-█-█-█-███-█-█-█████-███-█-███-█████-█████-█-█-█████████-
-----█-----------█-█---------█-█-█---█---█-█-----█-█-█---█-----------█---█---█-------█-█-----------█-
-█-█-█-███-███-██--█-███████-█-█████-█-█-█---█-█-█-█-█-███-█-█-█-███---█-██--███----█-█--█--████-████
---█---█-----█---█---------█-----█---█-█-█-█-█-█-█-------█---█-█---█-█-█---█-█---█-------█-----█-----
██████-█-███---███-█-█-█-████--█-█████████-███-█-███-███-███-█-█-███--------████-█-█-█-███-█████-████
-------█---█-█---█-█-█-----█-------------█-█---█-█-----█---█---█-----█-█-█---█-█-█---█---█-----█-----
-█-█-███-███--██-█-█-███--█-██-█-█-█-█-█████-███-█-█-█-███████-█████-█████-███-█-█-█--██-███-███-█-█-
-█-█-█---█-------█-----█-█---█-----█-█-█-█-----█-█-█---█-█-------█-----█-----█---█-█-------█-█-█-█---
---█--██-██---████-█-███-█-█---█-█-███-█-█-███████-█-█-█-█-█-█--██████--██-█-███-█-███████-█-█-█-████
-█-█---█---█-----█-█-█---------█-█---█-----------█-█-█---█-█-█-------█-----█---█-█---█-█-------█-----
████-████-██-███-█-█-█--██-███-█-█---██--█-███-███-███-█████-█---██-██-█-███-█-█-█-███-█████-███-█-█-
---█---█---------█---█---█-█---█-█---█---█-█---█-█---█---------█-█-----█-----█---█---------█---█-█---
-█-█-█-█-█-█-█-███---███-█-█-█-█-█-█████-███-█-█-██---██-█--█-██-████--███-█-███-█-█-█-█-████--█-██--
-█-█-█---█---█-█-█-█-------█-█---█-----█-█---█-----█---------------█-█-█---█-█-------█-█---█---█-█---
-█-█████-█-█-███-██-██████-███-█-█████-█-█--██---███-█-████--█--██---█-███-█-█████-█-█--██-██████--█-
---------█-█---█-█-█-█-----█---█-█---█-█-------█---█-█---------█---█---█---------█-█-█---█---█-------
-█-█-███-█-████--█-█---██--█-█-█-----██--███-█-█████-█-████--███-███-█----█-██-█-█-█-█-█-█-█-███-███-
-█---█-------------------█-█---█-----█-----█-------█-█-----█-------█---█-------█-█-█-█-█-█-----█---█-
-███-█-█-█-█-███---███-█-███---███-████--██--█-███████-██-██-█-███-█-█████-█--██--██-███-███-███-█-█-
-█-----█-█-----█-█-█-------█-█---------█-█-█-█-----█-------█-----█---█-----█---█---█-█-----█-----█-█-
-████--█-███-█-█-█-██-██-█-███-█-███-█-█---█-████--█████-█-███-███-█--█-████████-█-███-███-██--███-█-
-█---█---█---█-█-█-█-------------------█-------------------------█-█-█---------█-█---█-█-█-█---------
████-█-█-█-█-███-█-███-█-█---██--█-███████-█████████-█-█-█------█████-██████-█-██--███-█-███-███-██--
---█---█-█-█-█-----------█-----------█---█-------█---█-█-█---█---█-----█-█---█---█-------------█-----
█--█-█████---███-█-█-██-██-█-███-█-███-███-█-███-█████-█-██████-██-█████-█----██-██-████-█-██--█---██
-█-------█-█-------█-█-----█---█-█-----█-█-█---█---█-----------------█-----------------█-█---█-█-----
-█-█-█-█████-█-███-█████-█-█-██-█████-██-███-███-█████---███-█-███-███-███████-███████-█---█---█-█-██
---█-█-█---------█-----█-█-----------█-█---█---█-█-----█---█-█---█-█-█-----█---------█-█-█-█-----█---
-███-█-███-███-█-█-█-██-██-███-█-█-███-█-███-█████-███-█-█-███---███-█-███████----██-█-████--███-█-██
-----█---█---█-█-█-█-█-█-----█-█-█---------█-█-------█---█---█---------------█-█-█---█-----█-█---█---
████-█-█---█-███---███-█-██--█--████---█-██--█-███-███████-█-███-█--██-█-█-███-█-███-█-██-████---█-██
-------█---█-█-█-------█-█-------█-----█---█---█-----█-----█-█---█---█-█-----█-----------█-█---█---█-
██-███---█-███-███-█-█-█████-█-█-█-█-████-████-█████-█-██████-███--█████████-█-█-█-███████-██-██-█-█-
-----█-█-------------█-----█-------█-█-█-█-█-█-█---------█---█-----------█---█-----█-----█-----█-----
████-█-█-█-███-█---█-█-█-█---█-█-███-█-█-█-█-███-███-█-███-███-███-███---██--███████-███-█---███-████
-█-----█-█---█-█-█-█-█---█-█-█-█-----█-█-█-----------█-----------█---█-----█-----█-----█-------█-----
-███-███-███-███-█████-█--██---█-█-█-█-█-█████-█████-█-████-█-████-█--██--█----███-███-█-█-█-███-█-█-
-------█---█-------█---█-█---█---█-----------------█---------█-----█---█---█-----------█---█---█-█-█-
-█-█-███-█---███--██-█-██--█-█-█-██--█-█---█-███-█-███-█--██---█████-██--███-█-███-█-█████-█-███████-
-█-█-----█-█-------█-█-█-█-█---█-----█-█-█-█---█-█---█-█---█---------------------█-█-----█-█-----█---
█--█████--███████-████-█-█-█-█-█-----███-█████---███-███-███--████-████████--█-█-█-█-██-██-██-██-█-█-
---█---------█-----█---------█-█-----█-█-----█-█---█---█-█-----█-----------█-█-█-█-----█-------█---█-
-█-███-█-█-███-███-██--█-███-█████████-█-█--██-█-██-██-█--████-█-█████-█-█-█-█---█-███████-█-███-████
-----█---█-----------█-█-█-------█---█---█---------█-█-█-█---------█-█-█-█---█-█-█---█---█-█---------
██-█-██--█-███-█-███-█-█-███-█-███-███-███-██--█--██-███-█████-███-█-███---█-███-███-█-██--███---███-
---█-----█---█-█-------█-█---------█-----█-█---------------█-------------█-█-------------█-----------
---█████████-█---█-██--█--████-█--█-██-███---███-█████--██-███-██-██-█-█-██-█-██-██--███--██---█████-
-█---------█-█-█---█-█-█-█-----█-█---------█---█-----█---█-█-█-----█-█-█-------█-------█---█-█-----█-
-█-█-███-███████-███-█---█-█---█----██-███-█████-█-███-█████---█-█-█████-█-██-███--███-█-█---███-████
-█-----█-----█-█-----------█-█-█-----------█---█-█-----------█-█-█---█-█-█-------█-------█-█---█G█-█-
-█-█████████-█-█----███████---██-███-███-███-███-█--██-██--████--█-█-█-█-█-█-███-█-█-█-███-███-█---█-
-█---------█-----█-------█-----█---█---█-----█---█-█-----█-------█-----█-------█---█-█---█-----------
98 96