A----█-█-█-█-----█-█---█-█-█---█-█-█---█---█---█-█-------█-█---------------█-------█-----█-------█---
-███-█-█-█-█████-█-█-█-█---█-███-█-█-███-███-███--██-█-█---█---███████--██-███-█-███-█████-███---█-██
---█-------------█---█-█-----█---------█-█---█-█-------█-█-█-------█-------------------------█---█---
-███-█-----███-█-█-██-██---█-█--██-█-███-█---█-█--██--██-█-█--██-███-█████-████-██████████-█-███-█-██
-----█-█---█---█-----█---------█---█-------█---------█-----------------█-------------------█---█-----
-███-███-███-█-███████--██-█████-█████-██-█-██-███-█-█-█████-█-█-█----██-███-█-███-██--█-██-█-██-████
-█-----█---█-█-----------█---------█-█-----█-----█-------█-█-█-█-█-█---------█---█-------█---█-█-----
--██---█---█-█--██████-█-█-█-█-█-█-█-█-█-███-█-█-███-████---█-█████--███████-█-█████████---███-█-████
-█---█-█-█-█-----------------█-█-█---█-█-------█---█---█-------█---█-------█-█-----█---█-------------
-█-█-█-███--█-██-█-█--███--█████████████-███-██-████-███-█████-█-███-██████-███-███--█-███-█-█-█████-
-█-█---█-----█---█-█-----█-------█-█-------█-----------------█---█-----█-█-----█---------█-█-█-█-█-█-
██-█-████---█-██-████-██-█-█-███-█-█-███-█-██--█-███-██████--█-███--██-█-█--██-█-███-█-██-████-█-█-█-
---█-█---------█---------█-----█-------█-------█-------------------█---------█---------------------█-
██-██--███-███-█-█-█-█-█---███-██--█████-███████████████--██-█-███-█--█████-██-███-█-█-█████-█-███-██
---█-----█-----█-█---█-█-█-█-----█---█-█-----█---------█-----█---█-----------█-----------------█-----
-█-██--█-█-██-████-██-██-█-█████----██-██--███-█--████-█---███-██████-██-█-█-█-█████-█-█-████████--██
-█---█-█-----█-----------█---█-----------█---█-------█-█-█-█-------------------------█-█---█---------
███████--█-███-███-█-██--███-██--█-█████--███--███-███-█-███-█---█-█████-█-█-█---███-█████----█-██-█-
-█---█-------█---█-█-------█---█-█---------------█---█-█-█---█-█-------█---█---█-█-------------------
-██--█-█-███-█-███-█---███-█-█████-█-█-█-█-███---█----████-█-█-████--███-█████-█████-█-███-██-██-████
-----------█-█-█---█-█---█-█---█-------█---█---█-█-█-█---█---█---------█-----█-----█-----█-----█-----
-█████-███-█-███-█-█-█---█████-██████--█-█--████-██-██-███-███-█-█-█-█-███████-███-███--████---█---█-
-----------█-█---█-█---█-----█-----█-█---█-----█-------█-----█---█-█-----------------█---█---█-█-█-█-
-███-█-█-██-█--█████-█-█-█-█-█-█-█-█-█-█-█-█-█-█--██-███-█--████-█---███--██---█████████-█-███-███-██
-█---█-█-----█-------█---█-█---█---█---█-█-█-█---█-█-----█---█---█-█-------█-█---------█-█-------█---
-█-██--█-███-██--███-█-█-█-█-███-███---███-███-█-█-█-█-█-█████-█-███████--████---█-███████████-█---█-
-----█-█-█---█-----█-█---█-----█---█-█-█-------------█-█-------█-----█-------█-█---------------█-█-█-
-█-█-███-███-███-█-█-█-███-███-█-████----████---██████--██-███---███-█-██--███-███-█-█████-███---█--█
-█-█-----█---█---█-█-█-----█-----------█-█-█-█-----█-█-█-█---█-█-----█---█---█---█-----█-█---█-█-█---
-███-█--██--██-█-███-████-████-█-██-██-█---█-█---█-█-██---████-█████-█-█-██-██████-█-█---█-█-█-█-█---
---█-█---█---█---------█---█-----█-█-----█-----█-----------█-█-█-█-█-█-█---------█---█-----█-█---█-█-
---███-█-█-█-██--█-█--██-█████-█-█-███-█-█--██-███---██-███--█-█-█-█-█-█-█-█████-███-█████-█-█-█████-
-----█-█-█-█-█-█-----------█---█-█-█---█-----█-----------█-█-----█-------------█-█-█-█-█-----█-------
-█-█-█-███-███-█-████--█-█-███-█-█--██-█-█-███-█-█-████-█----█-███-█--████-███-███-█-█-███---███--█--
---█-----█-█-----------█-█-█-█-█-█-█-----█---█---█-------█-█---█-█-█-█-█-----█---█---------█-------█-
---█-███-███████-█-███-█-█-█-█████-█-█---█-█-█-█-███-█-███-███-█-█--██-███-█-███-█-███-█████-█-█---██
-█---█---█-█-█---█-█-█-█-█-----█-█---█-█---█-█-█-----█-█-------█-█-█---█-█-█-█-----█---█-----█-█-█-█-
-███-█████-█-█-███---██-████-█-█-█-████--███-█-██--███-█-█---█-█-█-█--██-███████████████-█-█████-███-
-█---█-------------------█---█-------█---------------█---█-█-█-----------------█---------█-█---█-----
████-█████-█████-█-█-███-█-███-███-███-████--████--████-██-███--██████-█-███████-█-███-█-█-█-████████
-----------█-----█-█-█-█-█-█---█-----█---█-------█---------█-------█-----█-------█-----█-█-----------
██-█-█-███-█-██--█-███-███████-███-█-███-███-███-█-███-███████-██████--█-█-███████-█████████-█████-██
---█-█-----█-█---█-----█-█-----█-------█-█---█---█---█---█---█-█-█---█-█-█-------█-----█-█-█-----█-█-
██-███-█████-███-█-█-███-█-█████-█-███-█████-███-███-███-█-█████-█-█----██-████████████--█-----███-█-
-█-█---█---------█-----█---------█-----█---█---█---█---█-----------█-----------█---------█-----------
-█-███-█--██-██---██-█-█---█-█-█-█-█-█-███-█--████-█-███-█-█---█-█-█-█-█-█-█---█-█████-██--█--██--██-
---█---█-█-----█-█---█-----█-█-█-█-█---█-█-------█-█-█---█---█-█-█---█---█-█-█-----█-----------█---█-
--█--████--█--██-███-██-████--████████-█-██--██-█-██-███-█████-███-█████████████-█--██-█--██--█-██-██
-█-----█---█-█-█-█-----------█-█---------█-----------█-----█-----█-------█-█---█-----█-█-█-----------
██-███-█████-█-█-█-███-█-█-███-███-██--█-█-█-█-█-████-█-██████-███-█-████--█-███----███████--█-████-█
---█---------█-█-----█-█---█-█---█-█-█-----█-█-------------------█-█-----█---█---------█-█-----------
███--███-█---█---█████-█████---█████-█-███-██--█---█-███-█-█-█-███-█-█-█-█-█-█-█-█-████--█-█-█-█-█-█-
-----█---█-█-█-----█-----------------█-█-█---█-█-█-█---█-█-█-----█-█-█-█---█---█-█---█-----█-█-█-----
██████-█-████--█-█-█████-███-█-███-███-█-█-██--█-███-█-█-███-███---█-███-█--████-█---█-█-█-█-███-████
---------█-----█-█-----█---█-█-█-----█-█-----█-----█-█-----█-█-----█---█-█---█---█-█-█-█---█-------█-
███-██-███-█-██--█---█-███-███████-█-█████-█████-███-█-███-███████-█-█-█-███--██-█-█-████-██████--██-
-█-█-█---█-█---█-█---█---█-----█---█---█-----█---█---█---█-----█---█---------█---------█-----█-█---█-
-█-█-█-█-██-██-█-█-█-█-█-███-███-█████---████████--█-█-███-█-██----█---█---███--█████-█--██----█-█-█-
-------█---------█-----█---█---------█-█---█---█-----█-----█---█-█-█---█-█-----------------█---█-█---
██--██████-█-█████-███-█-███---█-█-███-█---███-███-█-████--█-█-█-█-█████-███---█--█--█████--██████-█-
---█-------█-█-------█-█-----█---█---█-█-----------------█-█-█-█-----█-█-----█-█-------█---------█-█-
██-███-█-█-█-██--█-█-█-████-██-█-█-█-█--████-███-█-█-█-███-█████-█-███-██--███-███-█-█-███-█-███-█--█
-----█---█-█-█---█-█-█-█-█-----█-------█-------█-█-█-█---█-----█-█-----█-----█-█-█-█-█---█-█-█-█-█---
-█-███-█-███-█-███-█-█-█-█--████--██-█████-█-███-█-█-███--██-█--██-█-█-██--█-█-█-█-█-█-█████-█-█-████
-█-█-----█---█-----█-█-----------█-█-------█---█-█-█-█-----█-----█-█-█-█---█-█-█---█-------█---█-----
██-███-█-█-███-█████-█████-█---█-█-████--█-█-█-█-███-███-██--█████-█-███-███-███-███████-███-----███-
---█---█-█-█-------█-----█-█-█-█-----█---█-█-█-█---█-█-----------█-█---█---------█-------█-------█-█-
---█-█-█----██-███████-███████---███-█-█████-███-███████-█-█-█---█-█-█-█-███████-███-███-█████-███-█-
-█---█---█---█-█-█-------█---█-----█---█-----█---█-█-----█-----█-█---█-█-------------------█-█-------
██-█---█-███-█---█████-█████-███-██---█---██-███-█-█-█--████-███-█-█-█--██-█---█-███-█--██-█--██-████
-█-----█---█-█-----█-█-------█-█---█-█-----█-------█-█-----█-----█-█-----█-█-█---█-------█---█-------
-█-███-███--██--██-█-█-█-███-█-███-█████-----█-█-█-███-█-███-█████-███████-█-███-███-█-█---███████-█-
---█-----█-█---█-------█-█-█---------█---█-----█-█-----█---█-----█---█---█-█---█---█-█-█-█-------█-█-
██-███-█-████-██-█████-█-█-█-███████-█-█-█-█-███-█-██-████-█-█-█████-█-█████-███-█-███-█-███-█-█---██
-------█-----█-█---█---█-█-█-------█-█-█-█-█-----█-█-----█-█-█-----█-------█-█---█---█-█---█-█-█-█---
-█-██--██--██--█-█---█--██-██-█-██-███-█-███-█-████--█-███-█--████████-█---█---█-█-███-█-█-███-██████
-█-█---█---█-------█-█-----█-█---█-█-█-█-█---█-------█-█---█-----█-█-█-█-█-█-█---█---█-█-█---------█-
██-████-██-█-█-█-█-█--██---█-█-███-█--██---█-█-█-█-█---█-█████████-█-███-███-███--██-█████-█---█-███-
---█-------█---█-█-█---█-█-------------█-----█-█---█-█---█-█---------------█-█-█-------█---█---█-----
██-█-██--███-█-█-█-█████-██--███-█-██-█--█-█-█-███-█-███-█-█-█-███-█--█-██████-█████████---███-█-█-█-
-█-█-----█---█-█-█---█---------█-█-----█-█-█-█-----█---------█-█---------------█-------█-█-█---█-█---
-███-████--███████-█████---█-█-███-█-█-██-████--█████--████--██-████-█-██---█---██--█-█████--█---█-█-
-----█-------█---█-█-----█-----------█-█---------█-----------------█-█---█---█---------█---------█---
-█--████---█████-███-█-█-███-█████████-█████-█-██-█-██-█-███-█████-█--█-██--██-███-█████████████-████
-█---█---█-█---------█-█-█---█-----█-----█---█-----█---█---█---█---█---█-----------------█-----█-----
██-█-██-██-█-██----█-███-█-█-█-█████-███-█████---█████-█-███---█--██████-███---██-██---█████--█--███-
-------█---█-█---█-█---█---█-------█-------█-----█---█-█-----------------█---█-----█-█-█-█-█-------█-
-███--██-█-█████-█-█████-█-█-██--█-█--██-██--█-----█-█---█-█---█-█-███-█-█-█-███-█████-█-█-█-█-█----█
-----█---█---█---█-█-----█---█-█-█-----█-█-█---█---█---█---█-█---█---------█-█-█---█-█-----█-----█---
-███-███-█-███-███-████---██-█-██████████--███-█-█-███-███-██--█████-███-█-███--████-██████--███-████
---█-█---█-█-------█-------█-----------------█-█-█---█---█---█---█-----█-------------█-----█-█-----█-
-█-█-███-██-█--███-███--█--█-██----█-█-█-█-███-█-███-███-███---███-███---█-███████--██-███-█-█████-█-
-█-█---------------█-------█-█---█-█-█-█-█-█---█-█-----------█-█-----█---█---------------█---█-------
██-█-█-█-█-█-█-██-████-██--███-█-█████-█-██-██-█---█---█-█-█-███-█-██-█--█-█-███-█-█-█████████-█-█-██
---█-█-█-█---█-----█-----█---█-█-----█-█-█-----█-█---█-█-█-█---█-----------█-----█-█---█-----█-█-█---
-███-███-█-█---███-█-███-█-█████-█-█-█-█---█-█-█-█-█---███-█-████-██-███-█-█-█-█-█-█████-███-█-█-█---
-█---------█-█-█---█-█-█-----█---█-█-█-----█---█-█-█-█-----█-----█-█---█---█-█-█-------------█G█-█-█-
-██-██-███-█-███-█-█-█-█-█-█-█-█-█-█-███-███████-█-█-█████-█-█████-█-█-██--█-█-███-█-█-███-█-█-███-█-
-█-█---█-█-----█-█-█-█---█-█---█-█-█---------█-----█-----█-█-----█-█-█---█-█-----------█-█-█-█-█-█---
-█-█-███-█-█-███-█-███-█-█-██--█--██-█-█-███-█-█-█-█-█-███████-█-█-█████-█---█--██-███-█--██-█-█-█-██
-------█---█-█---█-█---█-█---█-█-------------█-█-█-█-----------█-----█---█-█-█-█-----█---█---█-------
96 94