A--█---------█---------█-█-█-█-█-█-█-----█---█---█-█---------█-█---------█-------█---█-█-----------█-
-█-███-█-█-███-█-████--█-█-█-█-█---█-█--██---█-███-█-█-█-█-██---████-█-██████-█--█-█---█-----█-█-█-█-
-█---------█---█-█-█-█-█-------------█-----█---------█-█-█-█-█---█---█-█-█---█-----█-------█---█-█---
-███-█-█-█-█-█-██--█-███-█-██--█-███-█-███-███████-█-█-███-█-█---█-█-███-██--█-███-█-█-███-█████-██--
-----█-█-----█---█-----█-█-█-█-█-█-█-█-------------█-----█-█-----█-█-----█-------█-█-------█---█---█-
██-█-█-█---███████-█---█-███-█-███-█-█-█-███████-█████████-█-█████-█-██-██-█-████--█████████--██---██
---------█---------█---------█-------█-█-------█-█-█-█-█-------█-----------------█-------█---█---█-█-
-███-████----█████-█-█-███-█--██-███████-███████-█-█---█-███--██████-█-█████-███-█████-███-█-███-█-█-
-█-------█-█-█-█-█---█---█-█-█-------------█---█---------█-█---█-█---█-----█-------█-█---------█-█---
-███-█████-----█-█-█-████████--████-█---██-█-██--██-██████-█-██--█--██-█--██████-██--█-█-█--██-█-█-█-
-█-----------█---------█---------█-█-------█---------█---█-█-█-----█-█-█-------█-----█-█---█---█-█---
██-█-█-███-█---█████-█-█-█-███████-█-███---█-█████████-███-█-███-█-█-█--████████-█-██--█████-████----
---█-█-----█-----█-------█-----------█---█-------------█---------█---█-----------█-█-------------█-█-
█-█--█████-███-███--████-█-████-██-███-███-██-█--██████--█████████----██-█████-█-█---███-█---██--█-██
-----█-----█-█---█---█-█---█-----█-----------█-█---------█-------█-----█-█-█---█---█---█-█-█---█-█-█-
-█-█-█-███-█---███-███-█████-███--██████████-█-█-█--██-█----███████-█-██-█-█-███-█-█-███-███████-█-█-
-█-█-█-----█-----------------█-----------█-█---█-----█-------█---------█-------█---█-----█-█-----█-█-
-██-████████-███-█-███-█-█-███-███-█-██-██-██-███-████-█-█--██--██-██-██-█████████-█-█-█-█-█-█-█--██-
---█-----█-----█-----█-█-█---------------█-----------█---█---------------------█-----█-█-█-█-█---█---
-█████-█-█-█-█-█-██--███-█-█-██--█████████-███-█-█████-█-█-███-███-███-███-███-███-███████-█--███--██
-█-----█-----█-█-------█-------█-----------█-----█-----█-----█-█-█---█---█---█---█---█---------------
-██████--█-█-█---█-█-█--██-█-█-█-█-███-█████-███---███-███-█--██-███-███████-█████████-██████--███-██
-█-------█-█-█-█-█---█---█-█-█-█-----█-----------█-------█-█-------█-----█-█-█-█-█-█---█-█---█-------
-█-█-█-███-█-█-█-█-█-█-███-███-███-█-█-████-██-█-█-█-█-█-█-███-█████----██-█-█---█-█--██-█-███-█----█
-█-█-█-█-█-█-█-█-█-█-█-------█-█---█-█-----█-█-----█-█---█---█-----█-----█---------█-█-----█---█-█---
████-███-█-█-█--█----████--█-████--███---██--██---█████████████--█-████-██-█-█████-█-█-███████-█-█-█-
-----█-█-----█---█-------█-------------█-----------█-------█-█-█-█-█---█---█-█---█-----------█-█-█-█-
█--█-█-█-█████--█--██--█-███████-█-█---█████--██-█-█--██-█-█-█-███-█-█-███-███-███-█-█-█████-████████
---------█-------█---█-█-----█---█---------█---█-----█---------█---█---------------█-█-------█-----█-
██-█████████-█-█-█-█--██-███████-█-█-███-███████-███-███-███-██-█--█-█-███-██████████--███████-███---
-------█---------█-█-------------█---█---------█-█-█-----------------█---█-█---█---█-----█-█-----█---
██-███--████-█-███-█-█████-█-█████-█-██--██████--█-█-███-████--████-███--█---█-----███-███-███-███-██
---█---█-----█---█-█-----█-----█---█-----------------█-█-----█-----█-----█-----------█---█-█---------
█-█--█-███-███-█-█████-█-███████--██--█--█-█-█-█-█-----█-██--███-█---█████-███-█-██-██-███-█-███-█-██
-----█---█-█-------█-----------█-------█-█-█-█-█-█-█---█---█-█---█-█---█-----█-█-█-█---------█-█-█---
-███████-███-█-█-███-█-███-█--██-███-█-███████--██--████--██----██-█-██-██████-██-------███-██-█-████
-█-█---------█-█---█-█---█-█-█-----█-█---------------█-------█-----█---------█---█---█---█---█-█-----
-█-█--██-███-█████-█████-███████-█████-█-███-███████-███---█-███-█-█-█████████-█████-█-███-█-█-██████
---█-█-----------█---█---█---█-------█-█---█-----█-------█-█-█---------------------█-█-------█-------
-███████-█-█-███-███-███-█-█████-█-█████-███---█-█-█-██--█████-██-██-█████-█████-██--████--███-█-████
-----█-----█-------█-█-----█-█---█---█---█---█-█---█-█-------█-----------█-----█-█-------------------
-██---█--█-█████--██-█-███-█--██--███--█-█████--██-█-█-██-██-█-█---████-██-█-█-█-█-█-█-███-█████-██--
---█-█---█-█---█-█---█-█-------█-----█-█---------█-█-█---------█-█-------█-█-█-█-█-█-█-█-------█-█-█-
-█-█-█-█-█-█-███-███-█-█-███-███████-█-█-███-█---█-███-█-█████-███████-███-█-███-█-███████---█████-█-
-█-█-█-█-█---------█-█-█-█-█-█-----█-█-------█-█-█---█-------█-----█-----█---█---█-----------------█-
---█-█---█-███-█-█████---------█-██--█--██████-██-██████-█-█-█-█████-█-███-█-███-█--████-█-█-█--█-██-
---█-█-----█---█-█---------█-█-------█-------█-----█---------█---█-█-█-----------------█-█-█-█-█-----
-██-█--█-█-█---██--██████████--██--█-█-███████---███████-██--█-███-███-█████-███-█-█-██-████████-███-
-█-█-█-█-█-█-█-------------------█-█-█---------█-----█-----█-█-----█-------█-█---█-█---------█-█-----
██-█-███-█-██-██-█-█-█--████-█---███-█-█-███-█████-█-██--█████--█--█-█████████████-█-█████-█-█-█-█-█-
---------█-█-----█-█-█-------█-█-█---█-█-█-█-----█---------█-----------------------█-----█-█-█---█---
██--██-█-█-█-█-██--██--█-█-█-██---█-██████-█---███---█-█-█-█--█████--███-███-███-██-█-████-█-█-█-█-██
-█-█---█-█---█-█-█-----█-█-----------------█-█-----------█-█-------█-█---------█-█-█---█-------█-█---
-██-██-█-█-█-█-█-███-███---█-█---█████-█-█-█-███-█-███-█-█-█-█-█-█-█-█-█-█-█-██-██-█--██-██-████-█-██
-------█-█-█-----█-----█-█-█---█-----█-█-█---█-------█-█---█-█---█-----█-█---█---█---█---------------
-███-█-█-█-███-█-█-█-█-██--███-█-█-█-███-███---█-███-█---█████---███-██████-█-██-█-█-█-███████-█████-
-█-█-█-------█-█-█---█-█-----█-█---█-█-----█-█-----█-█-█---█-------█-------------------------█-█-----
-█-█-█-█-█-█-█-█-█████-█-██████---████-█-█-█-███-█-█-███-█-█-███-███-█-█-█-███-███-█████-█--████---██
-█-----█-█-█---█-----█-█-----█-----█---█-█-█-█---------█-█-█-█---█---█-█-█-----█-█-----█-█-----█-█-█-
-█████-███-███-███-███-███-████--█---█-█-██████--█-███-█-███-██--███-█████-█-███-███---█--██-███-███-
-█-------█-█---█-----█-█---█---█-█-█-█-█---------█-█-█-█-█---█-------█---------█---█-------█-------█-
██-█-███-█████-██--██-██-███-██---██-█-█-███-█-█-█---█-█-███-█-█---█-███-█████--██-█-█-█-██████████--
-----█-------█---█-------------█---█-------█-█-█-----█---------█-█-█-█-----█-----------█-------█-----
██-█████-█--██-████--█-█████-███-█-███---█-█---█-█-███---███-█-███-█-███████-███-█-███-█--███-██-███-
---█-------█-----█---------█---█-█---█-----█---█---█-------█-█---█-█---█-------█-█---█-█-----█-█---█-
-█-███-█-███████-█-█-█--██-████-██-█-█████-█-███████-███-█-█-█████-█-█-███-█-█-█---████████--█-█-██--
-█-------█-------█-█-█-------------█-█-----------------█-------------█---█-█-█---█-----------------█-
-█-███--█████--█-█-█-█-███-█-█--█--█-█-███-█-███████-███---█-█-█-██---██-█-█████-█-█████--██-███-█-█-
-█-----------█-█-█-█---█-█-█-█-----█-█-█---█---█---█-█-----█---█-█-█---█-█---█---█---█-----█---█-█-█-
████-███-█-█---██████--█-███████-█████-███-█-█-█-████--█-█-███-███-█-█████-███-███-███-█-███-█-███---
-----█---█-█-------█-----█-█-█-------------█-█---------█-----█---█---█-----█-----█---█-█---█-█---█-█-
-█-███-██-██-█-███-█-███-█---███-███-███-█-█-█-█████-█-███-███-█---█-█-███-█---██--█-█-███---███-█-█-
-█-█---█---------------█-█---█-----█-█-----█-█-------█---█---█-█-█-█-█-█-█---█-█-█-█-█-----█---█-█-█-
██-█-██--█--████--██-█-█████---█-█-███-███-█-█-█-█-███-█-█-█-███-██---██-█-█-█-█-███-█-██-██-█-███-█-
-----█---█-█-----█-█-█-------█---------------█---█---█---█-█-█---█---------█-█-----█-█-----█-█---█---
███---█████-██-█-█-█-█-█████--███--█████-█-███████-█-█-█-█-█-███-█████████-█-█-█-██--█-█-█-█-██-██-██
-------█-█-----█---█-█-----█---█---------█---█-----█---█---█---█-█-█-------█-█-----█-----█-█---█-█---
██████-█-█-----█-█-███-█-█-█-████-█-██---█-█---███--██-█--██-█-███-█-█-███-█-█-███-███-█-█-█-█-█-█-█-
---------█-█-█-█-█-█-█-█-█---------█---█-----█-------█-█-----█-█---------█---█-------█-----█---█-█-█-
---█-█---█--██-█-█-█-█-███-█-█-█████████-███████-█-█-█---█-█-███-███-███-█-███-█-█-█-█-███-█-███-███-
---█-█-█-------█-----█-█-█-█-█-█-----█-█-█-----█-█-█-█---█-█-█---█-----█-█-----█-█-█-----█-█-----█-█-
---█-██--█-█-███-█-█-█-█-███---█-█-█-█-█-█████-█-█-█████-█-███---███-██--███-█-█-█-█-█-██--█-██--█-█-
-█-█-----█---█---█-█-█-----█-----█---█-█-----█---█-------█---█-█-█-----█-█-█-█---█-█-█-█---█-█-█-█---
--█--█-█████-█-█-███-█-█-██--█████████-█████-█-█---█--████-█-█-█-█-█-█████-█--█--█████-█-█-█---█-█-█-
-█---█-█-----█---█-----█-----------█-█-----█-█-----█-------█---█-----------█---█---█-█---█-█-------█-
-█-███████████-█-█████--████-███-███-█-█-█████-█-█-█-█-█████-███████-█-███-███-█---█-█--██-███-███--█
---█---█-█---█-█-----█---█-----------------█-█-█-█-█-█-----█-----█---█---█---█-------█---█-----------
-███-█---███-█--██-█-█-███████-███-███-█-█-█-███-█-█-█-█-█-█-█-███████---███████-█-███-█-█---█████-██
-█---------█-█-█---█-█-█-----------------------█---█-█-█-█-█-█-█-------█-------█-------█---█-------█-
-█-█-█-█-█-█-█-███-██-██-█-███-█-█-███--████-█-█-███-███-█████████████-█-█-█████-█-███--██-█---███-█-
-█-█-█-█-█-----█-------█---█---█-█---█---█-█-█-█-------█-------█---------------█-█-█-----█---█-█-----
-█████--██-██████--████████--█-█████████-█-█---█-█-█████-█-█-███-███---█-█-███----████-█-███-█████---
-█-----█-----------------█---█---------█-----█-█-█-█-█-----█-------█-█-█-----█-------█-----█-█---█-█-
-██--█-███████--██-█-███-█-█-███-█████████-█---█-█-█-█-█---███-█-█-█-███-█-█████-█-███-████--█-█-█-█-
---█---█-------█---------█-█---█-----█---█-█-█---█-----█---█-█-█-█---█---█---█-------█---█-----█-█---
-█-█-█-███-███████████-██--█-███-███-██--█-█-█--██-█-███-███-███---█████--████████-███-█-█████-█████-
-█-█-█---█-█-------------█-█---------█-----█-█---█-----█-------█-█---------█-█-------█------G█-----█-
--███--█████████-█-█-█----██-█-█████--█---████-█-█-█-█-███-█-███-███---█-███---█-█-█-█---█-█--██-███-
-█-█---█-----------█-█-█---█---█---------------█-█-█-█-----█-█---█---█-------█---█-----█-█-█-█-█-█---
-█-██-██-█-███-█--██████--████--████-█-█-███-----█---█-███-███--███--█-█-█-███-█-███-█-█-█-███--████-
-█-----------█-------█-------█---█-----█---█-█---█-█---█---█---█-------█---█---█---█-█-█-█-----█-----
96 92