A------------█---------------------------█-█-----█-----------█-█---█---█-------█-█-█-----------█-----
█--█-███████-█-████████--█--██-█-█-███-███-███-█--██-███-██-█--█-███-███-█-█-█-█-█-█-███-█-█-███-███-
---█-------------------█-----█-█-█-█-█-------█-█-------█-█-------█-█-----█-█-█-----█-----█-█---█---█-
--██-█-█-███-█--█--█████-████████--█-██--███-█--████-██----█-███-█-█-███-█-█-█-█████-███--██████---█-
---█---------█---█-█---█-----█---█-----█---█---█-█---█---█-█---█-█-----█-█-█-------------█---█---█---
-███-█████-█████-███-███-██-████-█-█-█-█████████-█---█-█-█---███-█-█-███--██-█-██--█-███████-█-███-██
---------█-----█-----█-█---█---█-█---█-█---█-█-█---█-------█-----█-█---█---█---█---█---------█-█-----
-███-█-█-███--██-██--█-████--█-█-█-███-███-█-█-███---█-███-███-███-███████████--█--█-███--████-███-█-
---█---█---█---█-█-----█-----------█---█-█-----------█-----------█---------█-█-----█---█-█---█-------
-███-███-███-█-█████████-█--██████-███-----█--████████----██-█████-███-█-███-█---█-█-████----█-█-█---
---█---------█-------█-█---█-█-█-█-█-------█-----█-----█-----------█-█-█---█-█-█---█-----------------
██-█-█--█████-██████-█-█-██--█---███-████-██----██-█████-███-███-███-███-███-███-███-█--█--█-█-███-█-
-------------------█-█-----█-----------█---█---------█-----█---█-------█-█---█-█-█-█-█---█-█-----█-█-
--██-█████-███-█████████-█-█-█████-███-█-███-█-█-██--█-███████████-----███-███--██-█-█-█-█-████-█-███
-█-█---█---------█---█-----█-----█---█-----█---█---------------█-█---█-█-█-----------█-█-█-----█-█---
█--█--████-█████---███-█-███-█-██--█-█-███████████-█-█-█-█-█-███-█-█---█-█-█-█-----██-█-██---███-█-█-
---------█-----------------------█-█-------█-----█-█---█-█-█-------█---█-----█-█-█---█---█-█-------█-
-█-███████-█---█---█-██--███-███-█-███-█████-█████-█---█-████-██-███-███-█-█-█-█-███████-█-█-█-█-████
-----█-----█-█-█-█-█-------█-----█---█---------█-█-----█-█-█---█---█---█-█---█-█---█-----█-█-█-█-----
-███-███-█-█-███-███████-█-█████-███---█-████--█-█-█-███-█-█-█---█-█████-█-█-█████-█-█--█-████-█-███-
---█-----█-------------█-----------█-█-█-----------█-█---------█-█---------█-█-█-----------█-█-█-█---
-███-█-█-█-█--████████-██-██-█-█-██-█---█--████--█████-█-███-█---█-█-█-███████-███-█-█-█-█---█-███-█-
---█---█-█-█-----------------█-█---█---█---------█---█-----█-█-█---█---█---█-----█-█-█---█-█-------█-
--████████-█-███-----█-█-█-████-█-██-██--█-█-███-█-███████-█--██-█-██--█-███--█-█--███████-█-█-█-████
-█---------█---█-█-----█-█---------█---█-█-█---------------█-----█---█-------------█-----█---█-█-----
-█-███-█-█-███-█-█-█--██---█-█---█-█████-█-----█-███████-███-█-█-███-█--██████-█-█-█-███-█-██--█---██
-█-----█-█---█-------█---█---█-█-█-------█-█---█---█-█-█-█---█-------█-------█-█-█---█-----------█---
████-████-██---███--████-███---█----████-█-█-█-████--█--████-████--█-███-█-█--█--█████-████████-█████
-----------█-----█-----█---█-█-█-█---█---█---█-------------█-█---█---------█-█---------------------█-
-█-█-█-█-█-█-█-█-███---█---███-█-███-█-█-███-███-█-█-█-█-█-███-█-███-███--████-█-███-█-█████-█-█-██--
---█-█---█-----█-----█-█---█---█-----█-█-█-█-█-█---█-█-█-█-----█---█-█-------█-█---█-█-----█-█-█-----
--██-█-████-██-█-█-█-██--███-█-█-█-█-█-█-█-███--██--█---████-███-███-█-█-█-███████-███-███-█████████-
---█-----█---█-█-█-█---█---█-█-█-█-█---█---█-----█---█-----█---█-█---█---█-----█-----█-----------█-█-
-█████---█-█-█-------███████████████-███-█-███-███-█-█-███-█-█-█-███-█████████-█-█---███--██-███-█---
-█---█-█---█-█-█-█-----------------█-█---------------█---█---█-█-----------█-█---█---█-----█---------
-█-█-█-██-----██-█-█-█████-█████-█-███-█-██-███-██-███--██-███-█-█-█-----█-█-███-█-███-███-█-█-███-█-
-----█-----█-----█-█---█-█-------█---█-█---------█---█-------█---█-█---█-█-----------█-█-------------
-█-███-██--█-█████-█-█-█-███-█-█-█-███-█████-█--██-█-█-█-█-███-██--█████-█-███---███-█-█-██-██-███-██
-█-█---█---█---█---█-------█-█-█---█-------█-------█---█-█---█-----█-----█-----█---█---------█-█-----
---███-███-█---█-██--████-██-█-█-█-█████-██-██-█████-█-███-█████████-███████--█--████--█████-█-█-███-
-█-█---█---█---█---█---█-█---█-█-█-----█-----█-----█-------------------█-█-█---█-----█-█-█---------█-
-█---█-████--███---█-███-█-----█-███-█-█-██-████-█████---█-████--███--██-█-█-██--███-███-█-█-█-█-█-██
---█---█-------█-----------█---█-----█-█---------------█-------█---█-------█-█-------█-----█-█-█-█---
-█-█-██-██-█--█--███--████-███████-███---███████-███-█-██--█--████-█-█████-█---█-█-███-███-███-██████
---█-------█---█-█-----█-------------█---------█-█---█---█-----█-█-█-----█-█-█-█-█-------█---█-----█-
-█-█-█-███-█-█---███-███████-█-███-█-███-█-█-█-███-█-█--█-██-███-█████-█-████████-██-█--█-██████-█-█-
-█-█-█-█---█---█-█---------█-█-█---█---█-█-█-----█-█---█-------------█-█---█-█-------█-----------█---
-█-█-█-█---█-███--██-█-███-█-███-█-███-█-█---███████-███--██-█-█-███-█-███-█-█-███-█-█-█--█-██-█-███-
---█-█-█-█-█---█-█---█---█-█---------█---█---█-█---█-------█-█-█---█-█-█-------█-----█-█---█-█-█-█---
██-█-█-███████---█--█-██-█-█-█-███-█-█████-███-███-█-█---█-█--█████--███-█-██████--█-███-█-█-█-███---
---█-█-█---------█-█-----█-█-█-█---█---█-█---█---█---█-█-█-█-█-----█-------█---█-█-------█-----------
-███-███-█-█-█-█-█████-█-██--█-█--█--█-█-█---██--█-██████-██-█---██--█-█-███-█---████-████-█-███-███-
---█-----█-█---█-█-----█-----█-█---█-█---█-----------------█---█-----█-█-----█---█---█---█-----█---█-
-████--█████-███-███-█---█---███-█-█-█████-█-███-█-█-█--██-█-█-█-█-███-███-███---█-█---█████████-█--█
-█---------█-█-----█---█-█-█---█-█-█-------█-----█-█-█---█-█-█---█-----█-----------█---------------█-
██---█-█-███-█████████-█-█-█-███-█---██-████-████-████-█████---████--██-████-█-█-███---███--██-███-█-
-█-█-█-█---█-------█---█-█-█-█-------------█---█-----█-█-----█-----█-█-█-█---█-█---█-----█-█-█-█-█---
-█-█-█████-█-███-███-█-███-███-███---███-███-███-███--███---█--█---█-█---███-█-███--██-█-███-███-█-██
---█-----------█-█-█---█---------█-----█---------------█-----█-█-█-------█-█-----------█---█-█-------
-█████-███-█-█-███-███-███-█████-█████-██--████-██-███-█-███-███---█-███-█-█-█-█---███--████---██-██-
---█---█-----█---█-----█-------█-----█-█-------------█-----█---█-█-█---█-----█-█-█-------------------
-█████---█-███-█████-█-██--█-███-███-█-███-█████-█-███-█-█---█-██--█-█-█████-████-█-████-█-█-███--███
---------█-█---█-------█---█---█---█-█---█-------█-----█-█-------█---█-█---------------█-█-█---█-----
-███-█████-█████-███-███-█-███-████---██-█-███-█-███-█-█████-███████---█-█-█---██-████---█-█-█-█-█-██
-█---█-------█-█-------█-█-█-----█-█-█-█-█-----█-----█-----------█-█-█-█---█-█-------█-----█-█---█---
████-███-█--█--█████-█-███████-█-█-███-█-█-█-█-█-█-███-██---██-█-█-█-███████--████-█████-█-███████-█-
---------█-------█-----█-----█-█---------█-█-█-█-█---█---------█---█-----█---------█-----█-------█---
-███-█-█-█-█-███---███████--██-██--████--███-███-█-█████--██-████--███-█-█---█-██--█--█--███-███████-
---█-█-█-█-█-█-----█-------------------█-█-█---█-█---█-----------------█-█-█-█---█---█-------█-----█-
-███-█-███-█-███-█-█-███-█-█-████--█████-█-███-█-█████-█-███-█-███-█-█-█-███-█████-█-███-██████--████
-█-----█---█-------█-----------█-------█-█---------█---█-----█---█-█-----█---█-----█---█-------█---█-
-███-█--█-██-█████-███-█-█-███-█-██--█████-█-█-██-█-████-███-█-█--██-███---█-█-█-█-█-█-█---████--███-
-█---█-----█---█-----█---█---█-█-----------█-█-------█-█-----█-----█---█-█-█-█-█-█-█-█-------█-█---█-
--██--██-█-█████-███████-█-███-█-███----███--███████-█---█-██-██-███-█████-██--█-███-███---███-█-███-
---█-█-----------█-----█-------█-█---█-█-----------█---█-█-█-█-█-█-----█-█-█---█---█-█-------------█-
-█-█-██-██-█----██-█-█--██-██--█████-█████-----█-███████-█-█-█-███-███-█-█-███████-█████-█--██████---
---█-█-█---█-█---------------------█-----█---█-█-------█-----█-█-█-█-----█-------------█-█-----------
██-███--█-██████-█████-████-██████-█-█-███-███-███████-█-█-█-█-█-███---█████-█-███-█████-█-██-██-█--█
---█---█---------█---------█---------█---█-█-----------█-█-█-----█---█-----█-█-█-█-------█-----█-█---
-█-█-█-███████-█--████-████████-██-███-█████████-█████-█-█-█-█████-███████████-█-█-█-█---█-███---███-
-█---█-█-------------------------█---█---------█-----█-█-█-----------█---█---█-█-█-█-█-█-█---█-----█-
-███-█████-███-█--████-█████---█████-█-█-█████-███-███-███-█-███-███-█-███-███-█--██████-█-███-███-█-
-█-----█-----█---█-█-------█-█-█-----█-█---█-----------█---█-█-----█-------------------█-----█---█-█-
-███-█-█--███--█-█-███-███--██-█-███-█-█-█-███-----█-█---█-██--█-███-█-███--██-██████████--█-█████-██
-█-----█-----█-----------█-█---------█-█-█---█-█---█-█-█-----█-█---█-█---█-█-█-----█---█---█---------
--██-█-███-███████-█-██-██-███-███-█████-█-█-█-█████-█-██--██--█-█-███-██-██--████-█--████--███--█-██
-█-------█-█-------█-----█-------█-----█---█-█-█-------------█-█-█-----------------█-█-█-█-----█-----
-█-█----████-██--█-█-█--██-█-██--███-█-██-██-█--████████---█-█-█-█-███-██--█-█-█████-█-█--██--███--██
-█-█-█-█---------█-█-------█-------█-█---█-------█-------█-█-█-█-----------█-█-█---█---█---█-----█---
-█-█--████--█-████-█---███-█████-███-█-█████---███-█-█--██-█-███-█-█-█-███-███-█--██-█-███-█████-█---
-█-█-------█---█-----█---█-----█---█-█-----█-█-----█-█-█---█---█-█-█-█---█---█-------█-----█---█-█-█-
-█-█---███--██-███-███-███-█-███-███████-█████-█-███-█-██-█--█-█---█-█-█-███-██--█---█-█-█-█-██-██--█
-█-█-█-█-----█-----█-----█-█-█---█-----------█-----█-------█-█-█-█-█-----------█-█-█-█-█-█-----█G----
-█-█-█-█-█-███-█-█-███-█-█-█-███-█████-█████-█---█-█████-█████-███-███████-███-█-███████████████--███
-█-█---█-█-----█-█-----------█-----█---------█-█-█-----█-----█-█---------█-█---█-----------█---------
--██--██-█-█████-█████---█████-██--███--████-█---█-█████-██-█████---██████-██--█-█-█-█-█--██-███--███
-█---█-------------█---█-----------█---------█-█-█---█-█-█---█-------█-----█-----█---█-----█---------
--████████-███-█-███-█---█-██--█-██--█-█-█████-███-█-█--██-███-█-█-█-█-██-███---██-█-█-███-█-█████-██
---█-------█-----█---█---█---█-█-----█-█-----█-█---█-----------█---█-----█-█---------█---------------
-███---█-█-----█----██-███-█-███████-█-██--█-█-█-█-█-█-█---█-█████-█-█-███-█-█-███-█-█-██--█████--███
-█---█-█-█-█-█-----█---█---------█---█-█-------█-█-█-█-█-█-█-----█-█-█-------█-█---█-█---█-----█-----
92 96