A--█-█-------█-------█-█---------█-----█---█-----█-------█-------█-█-█-█-█-█---█-----█-█-----█---█-█-
-███-█---██-██-██████--█-███-███████-██-██-███--██--██-██--█████---█-█-█-█-█-█-█-███---█-███-█-███-█-
-----█-█---------█-█-█---█-█-----------------█-█-█-█---------█-----█---█-----█---█-----█-------------
██-█-█-█-███████-█-█-█-█-█-█-███████-████--███-█---█-█-███-█-█-████-██---██--██-██-███████-█-███████-
-------█-----█-█-█-█-█-█-----█---------█-█---------------█-█-------█-------█-█-----█-█-------------█-
██--██-████-██-█-█-█--██-███-█-█████-███-█--██-█-██-██---█-█-█--██-█---█████-███-█-----███████-██████
-------█---█-------█-█---█-----█-█-█-█---------█-----█-█---█-█-█---------█-█-█---------------------█-
-█--██-█-█-█-█-███-█-█-███-█████-█-█-█-█-█-███████-███████-████-██████---█-█-█---█-███████-█-██-██---
-█-----------█-█-█-█---█---------------█-█-------█---█---------█-█-█-------------█-------------------
██-----█-███████--████-█---██-████████-█-█---█---█████-████-██-█-█-███-██----█-█-█--██--██-█-████-██-
---█-------█---------------█---------█-█-█-█-█-█-------█-█-█-█-----█-█-----█-█---█---█-█---█---------
-███-███-███--██-██-█-██████-██--███-█-█████████-█-██--█-█-----█-█-█---█-██--██--███-█---█-███-███-█-
-----█-█-------█---------------█-----█-█-█---█-------█-----█---█-█---█-------------█---------█---█---
-██----███-█-███-█-█---█-██--██--█-███-█-█-█████-███-█████-███-█-█---█-█-██-████---█-█-█-█-████████-█
---█-----█-█---█-----█-█---█-----█---█---------█-█-------█-----------█-█-------█-█-█-█-█-█---█-----█-
-█████-----█████--████-█-█-█████-█--███--█--████-█████-███-█-█-█-███-█-█-█-█-█-█-█-█-█-█-██----█████-
---█---█-█-----█-------█-█---█-█-------█-----------█-█---█-█-█-█---█-█-█-█-----█---------█-█-█---█-█-
-█-███-█-███-█-███-████--███-█-███-█████-█---█-███-█-██-██-███-█████-██████--███-█-█-██-██-█-█--██-█-
-█-█---------█---█-----█---█-----█---█-█-█-█-█-█---------█-█-----█-----█---█---█---█-----------------
--██-███████-█-██--█████████-█-███████---█-███-███-█-█-█-█-███-██-███-██--████-█-██--█-█████-█-███-█-
-█-█---█-------█-█---█-----█-█---------------█-------█-█-----█---------------█-█---█-█-----█-█---█-█-
---█-███-█-█--██-███-███-█-███-█-███-█-███-████-██-█-█-█-█████-███-█-█-█████---█-███-████-██-████████
-█-------█---------█-----█-----█---█-█-----------█---█-█---------█-█-█-----█-█-█-█---------█---------
██-█--████-█-█-----███████-█-███████-█-████--█████-███-██--█████████-█████-█████████-█-█-███-███-███-
-----█-----█-█-█-█-------█---------█---█-----█-------█-█-----------█-█-█---------█-------------█---█-
-█-███--██-███-█-███-█-███--████-█----██-█-█████-███-██████-██--██-███--██--████--█--█---██-█--███-█-
---█-█-█-----█-----█-█---█-----█-----█---█---█---------█---█---------------█-----█---█-------█-------
-█-█-█-█---███-█-█---███-█-█-█████-█-█--██-██-██-█--████-█████-███████████---█----████-█-█-██--█--██-
-█-█---------█-█-█-----█-█-█-----█-█-█-█-█---█---█-█---------█-------█-█---█---█---█---█-█-█---█-----
-█-█-█-█-█---█-█-█-███████████-█--████---█-█████-█-█-█████--████-█-███-█-█--████-█████-█-███-███████-
-█-█-█-█-█-█-█-█-----█-█---█-█-█-------------█---█---█---█-------█-----█-█-----------█-█-----------█-
-█████---█-███-███-███-█-█---███---█-█-███--██-█-█-███--██-█-███-███-███████-█-█-███---█-█-█-███-█---
-█-------█---█-█-█---█-----------█---█---█---█-█-█-----█-█-█-█-█---█-----█---█-------█-█-------█-█-█-
██-█-█-█-███-█-█-█-███-██--█---█████--██-█-█--████-███-█-█████-███-█-██████-██████-█-███-█---███-█-█-
-█-----█---█-█-█-------█---█-█-----█-------█-----█---█-----------█---------█---█-█-█---█-█-█-------█-
-██-██-███-█████-███---█-█-███-████████--█-█████-██--███-███-███████-█-█████-███-█---█-█-█-█-----██-█
-------------█---█---█-█-█---█---------------█---------------------█-█-█-█-------█---█-█---█-█-█---█-
████████---█████-███-███-███-███-█-█--████-█████-███-██████--██--██-████-█-███████-█-███-█-█-█--██-█-
-█-------█---------█---█-█---------█---------█-------█-----█---█-----------------█-█---█-█-█---█-----
-█-█████-█-█-█-█████---███-█-███---████--█-██---██-█-█-████-██-█-███-███-█-███████-███-█---███-██--█-
---█-█---█-█-------------█-█---█-█-----█-█-------------█-█-█-------█-█---█-------█---█-█-█---█-█---█-
████---█-█████-█████-█---███-█--██-████--█-███-███-███-█---█-█-█-███-█-█████--████-██-██████-█-███-█-
-------█-----█-█-----█-█---------------█-█---█---------------█-█---█-█---█-█-█---█-█-----------------
████-█-███████-███-█-███-██-████-███-█-█----███--█-████-█--██-██████-█-███-█-███---█-█-█████████-███-
-----█---------█---█---█-█-█-█---------█-------█-█-----------------█-█-█---█---█-----█---------█-----
█-████---█-████--█-█-█████-█-█---██----█-██--████-███████--█-█-█████████---█-███-███-██-███-██-███-██
-------█-█-----█-█-█-------------------█---█-----█---█-----█-█---------------█-----------█-█-█-------
██--██-██----█-█-█-█-███-█---█-█████---█-█-█-█-█---█-█--████-████-██-███-███-█-█-█-███-█-█-█-████████
-----█-----█-█---█-----█-█-█-█---█-█-█-█---█-█---█-█-----█-------█-█---█-█-█---█-█---█---------------
██---█-█-█-███-███-███-███-███-███-█████-█-███-█-█-█-███████-█████-█-█████-██--█████-█████-█-█-█-████
---█---█-█---█---------█-█---█-----------█-█---------------█-------█---------------█-----█-█-█-█-----
-███-██--███-█-█-█████-█---███--██-████--█████-██-███████-████-█-████████--█████--██-█-███-█---█-███-
-----------█-█-█-█---------█-----█---█-█-----█-------█-█-----█-█---█---------------█-█---█-█---█-----
-█-█-█████-█-█-██-██-█-█---███-█-█-███-██-████-█████-█-█-█████-██-████-███-███████-█-█-███-███-█-████
-█-------█-█-█-------█-------█-█-█-----------█-----█---------------█-----█-------█-█-█---------█-█---
-█-███-█-█----████-█-█-████-███--█-█---██████--█-█-███-██████--█████-█-█----████-███-████████--██--█-
-█---█-█-█-█---█-█-█-█---------█-----█-█---█-█-█-█---█-------█-----█-█---█-----█-█-----█-----█-----█-
██-██-██-████--█-█-█--█--█-█-██--█-█-███-██--███-█████-█-█-█-█-█-██--█-█████-█-█-███-███---█████████-
-----█-█-█---█-█---█-█---█-----█---------------█-----█-█---█-█-------█---█---█-----█-----█-█-------█-
-█-███-█-----███████-███-█-█-█--████-███-█-█-███-█-████--██---█---██-█-██--███-█-███████-█████-█-█-█-
-█---█-█-----█---█---█---█-█-█---█-█---█-█-█-----------█-█-----█-----█-------█-----█-█-█-█-----█-█---
-█-█-█-█-█-█-█-███---█-███-█-█-█-█-███-█-██--███-███-█████-██-██-█--██-███-█-██-████-█-█-█--██-█-████
---█-------█-----█-----█---█-█-█-█---█-----█---█---------█-█-----█-------█-----█-█-█-------█-------█-
██-█-█████-██---██-█-█-█-█-█-███-█-█-█---█-███--██-█████-████--█-███-█-███-███-█-█-█-███---█-█-███-█-
---█-----█-----█---█-█-█-█-----------█-█-█-------█-----█-------█-----█-----█-█---------█-------------
█████--██████████-██-█-██--███-█-█---███-█-██-███-██-██-████████-█████---███--██-█-█------██--███-██-
-------------█-------█-█---█-----█-------------█---------█-----█---█---█-------------█-█---█-█-------
-█--█----███-███-█-█-█████████-█-███-█-█--██-█---█--██-███--████---█-██--█-███--████████-█-██--███-██
---█---█-█-------█-█-------█-----█---------█---------█-----------█-█-----█---█-----█---------█-----█-
██-█-███-█-█-███-█-█-██--█-█---█-█---█-███--████-█-███-█-█████████-███--██████-█-█-█-█-█-█-█-█-█████-
---█-----█-----█-█-█-------█-----█-█-----█-----█-█-█-█-----------█---█---█-----█-█-----█-█-----------
-█-█-█--████--██-█-█-███-█-█-█-███-█-█--██-███-█-███-█-█████-███-█-██-██-█████-███--█-██-█-███--████-
-█-█-█-----█-----█-█-█---█-█-█-█---█-█---█---█-█-----------█-█-█-█---█-------█-------█---█---------█-
██-█---█-███---████████-██-███-█-█-█████---███-█-█-█-██-██-█-█--████-█-█-█████-█-█-█-███-█-███-█-█-██
-█---█---█---█---█---------█---█-█---█---█-----█-█---------------------█-----█-█-█---█---█-----█-█---
-█-█████-█-█--██---█--██-█-███-█-█-█-█----██-█-█-███-█-██--█-█-███-██--███----██--█--█-███-██-█--█-█-
-------█-█-█-█-█-█-█-█---█-----█---█---█-█-█-█-█---------█-█-█---█-------█-█---█---█-----█-█---█-█-█-
-█-███-███-█-█-███--█-██-███-█-█-█-███-█-█-█-███-█-█---█--█-██-███-█████-█████---██--█-███-█-███-█--█
-----█---█-----█-█---█-------█-█-█---█-█---------█---█-----█-█-█-------------█-█---█---------█---█---
-█-█-█-█-█-███-█-███---█-█---█-███-█-███-█-█████-█-█-█---███-█████-█████-██████--█-█-█-█-█-██-██-█-█-
---█-█-█-----█-------█-----█---█---█-█---█-----█-█-█-█-█---------█-█-----█-█-------█-█-█-█---█-█-█-█-
██-█-█████--█-██---███-█-█-███-█-███-███-███-████--█-███-█-█-███-█-█-█-█-█-██----█-███-██--█-█-█-███-
---█-█-------█---█-█-------█---█-█---█---------█---█-█---█-█---█-█---█-------█-█-█-█-----█-------█-█-
-█-███-███-██--██--█-██---██--██-██--███-█-██-██-██-█--█---█-█----█--█-██-█-██-█-█-███-█-█-█--███--██
-█-█-█-------█-█---█-----█-----█-----█---█-------------█-█-█-█-----█-█-█-█-█---█-█---█-█-█-----------
██-█---█-█-█-█-███-█████-███-█-█--████-█-█---█████-█-███-███-███-█-██--█---█-█-█-████--██-██-█-█-████
---█-█-█-█-█-█-█---█-----█---█-█-----█-█---█-----█-█---█-█-█-----█-█-------█-------█---█-█---█-█-----
██---█---█-█████-█-██--█████-█-█-█-█--██-█-█-█--██-█-███-█-█--██-█-█-█████████--████-█-█-███████-██--
-----█-█-█---█---█-█-----█-------█---█-----█-----------█---█---█-----█-█---█-█-----█-█-------------█-
█--███-███---█---█----██-███--██-███-█-█--████-█---█-██-████-███-█-█-█-█-█-█-----█████---███-█---███-
-----█-------█-█-█-█---█-------█---█-█-█-----█-█-█-█-----------------------█---█-------█-█---█-█---█-
-█-█-███-----███-███-███-█-███-█--███--█-██████-██-█-███-█-█-█-██--█-█-███████-███-███-█-█-█-███-███-
-█-█-█---█---█-----█-█---█-----█-----█-█-----█-█-█-----█---█-█---█-█-----█-----------█---█-█---------
-█-█████---███████-█-█-█---████--█-█████-█-███-█-█-███-█████-█---███████-█-█-███████-█-███-█-█---███-
-█-----█-█-█-------█---█-------█-█-█---------█-█-█---█-█---------------█---█---------█---█-█-█-█---█-
---█-██--█-█████-█-███-█---█-███-█████-█-█-█-█-█---█████-█-█-█-█-█████-█-█---██-█--███-███-█-█-█-███-
-█-█---█-█---█-█-█---█-█-█---█-█---█---█-█-█-------------█-█-█-█-------█---------█-----█---█---█-█---
-███-███-█-█-█-███-█████-█-███--██-█-█-███-█--██---███-█-█--████-█--████-██--█-███-██-████-█-█--█████
---█---█-█-█---█-------█-█-█-------█---█---------█---█-█-------█-█---█-----------█-------█-█-█-------
---█-█████-███-█---█-█-█-----█-█████-█-█-██--█-█████-█████--██████-█-█-█-███-█-----██████-███--█-████
---------█---█-█-█-█-█-█-█---█-█-----█-█---█-█-----------█---------█---█---█-█--G------█-------█-----
100 80