A--------█---█-█---█---█-------█-----------█-█-------█-█-█-----------█-█---------█-█-----█-█-█-------
-█--████-███-█-█-█████-█-█-███-█--██-█-█-███--██-███-█-█-█-███-██████--█-█-█-█████-███-███-█-█--██--█
-█-----█---------------------█---█-----------█---█-----------█---█---█-█---█-------█-█---█---█-█-----
-███---███-█-█████-█-█---█-███-█---█████--██-███-█---███-███████-█-███---███-█-███-█-█-█████-█-█-██-█
---█-█-█---█---█---█-█---█---█-█-------█---█-----------█-----█---█-----------█-----------------------
-███-█-█--██-█████-█-█-███-███-█-█-█-█-█████-███-█-█████-█--██████-█-███--██---██████--██--██--███-██
-█---█-----█-█-█-█---█---█---█---█---█-------█---█-----█---█-----------█---------█-█-█---█-█-----█---
-███-█-█-█████-█-█-███-█---███-█-█-█-███-███---█---███-█-███-█████-█-█████-█---█-█-█-█-█-█████-██████
-█---█-█---------█---█---█-----█-█-----█---█-█---█-█---█-----█-█-█-█-█-----█-█-█---█-█---█-----------
-███-█-█-█--██████-███--██--██-█████-█-██-██-█--█--█-████-██-█-█-███-████--█-█-█-█-█-█-█-██-████-██--
-----█-█-█---------█-█-█-----█---█-█-█---------█-----------------------█-█---█-█-█---█-█-█---------█-
-███-█-█---█-████--█-██--█████-███-████-█████----███-████████---██-█--█--██████-██-█-███-█-█-█-█--██-
-█-█-█-█-----------█-█-----------------------█-----█-------█-----█-█---------------█---█-------█-----
██-█-█-█████-███████-█-███-███-█-██---██████-███-████-█--██--█-██-████-█████-█-███-███--██-█████████-
-------█-█-------█---------█-█-█---█-----------█---------█---█-------█-█---█-█-█-----█---█---------█-
-█-█-█-█-██--█-█-█-███-█-███-█-██████-█--█--██████-█-██-██-███████-████--████████--███████-███████-██
-█-█---------█---------█---------------█-█-------█-█---------█-█---█-█-█---█-█---█-------█-----------
-█-███-███████-█-█-█-████--█-█-█-███-███-█--██████-----█████-█-█-███-█-█--██-█-█-██-████-█-█--███████
-█-------------█-█-------█---█-█---█-----█-█---------█-----█---█-------█-█-----█-----█-█-█-█-█-█-█-█-
██-█--██---███-███-███-█-███-█-███-███-███---█████-█-█-█-███-█-█-█---███-█-███-█████-█-█-█████-█-█-█-
---█---█-█---█-█---█-█---█-█-█-█-----█-█-█-------█-█-█-----█-█-█-█---█-█-----█-█-----█---█---█-------
█--██--█-█--██████-█-█████-█████-██--███-█-█████--██████---███████████-█-█-███-█-██-██--████-███-███-
-█---█-█-█-----------------█---█-█-█-█---------------█-█-█-----------------█-█-----█-█-----█-█-------
-█-█-██--██--██--█-███-█-█-█-███-█-█-----█-█-█-█-█-█-█-█████-█-█-█-█-███-███-█--████---█████----██-█-
---█---------█---█-------------█-------█-█-█-█-█-█-█-------█-█-█-█-█-----------█-█-█-█-----█-█---█-█-
█--█-█████---███-█████-█---█-█-██-███-██████-█-████--█████-███-███████-█████-███-█-█-█-█████-█-█████-
---█-----█-█---█-----█-█-█-█-█-----------█---█---------█---█---------█-----█-------------█-█---------
██-███-███-███-███-█-█-█-██--███-█-█-███-█-███-█████████-██-█--█-█████-█████-█-█-█-█-███-█-█-███-███-
-----█---█---█---█-█-█-█-----█-█-█---█-█-█---------█---█---█-█-█-█-█-█-█-█---------█-------------█---
--██-█-█---█-███---███-█---█-█-█████-█-█-█--██-█████-███-█-█-█-███-█-███-█-█-████--█████-█████-█-████
-----█---█-█---█-█-█-█-█-█-------█-█-----█---█---------------------█---█---█-----█-----█-----█-█-█---
---█---█-██--███-█-█-███-█-█-█-█-█-█████-█-█-█-█-█-█-█-█████---██-██-█-█--█--███████████-███-█████-██
-█-█-█-█---█---█-█---█-----█---------█-█-█-█-------█-█---█---------█-█-----█---█---█-█---------█-----
██-█-█-███-█-███-█-█-███-███-█████-███-█-█-█-█-█-█-███-█-████-██-████-██-█-█--██-███-█-█-█-█-█-███-██
---█-----█-█-█-----█-█-----█---█---█---------█-----------█-█---------█-█-█-█---█-█---█-█-█---█-----█-
█-██-█-███████-█████---████--█-█-█-█-█-███████████-█--██-█-█████-█-███-----█---█-█-█-█-███-██-██--██-
-----█---------█-------------█-█-█---█-█---------█-█-█-------█---█-------------------------█---█-█---
-█-█-█-█-█-█-█-███-█-███-█-███-█---███████-███-███████-█-█--█-██-████-██--█--█-█████████-███-██-███--
-█-█-█-█-█---█---█-█---------█---█-----------█-------█---█-------█---█-----█-------█---█-----█---█---
-█-█████-█-███████-█-█-█████-███-███-█-█████--█--█-█-█████-█████-█-██--█---█-███████-████--███-█-███-
-█-█-------------█-█-------█---█-█---█-----█-----█-█-█---█-█-█-------█-█-█-█-----█-------█-----------
-█████-███---██--█████-███-█-███████-█-█--██-█████-██--█-█-█---███-█--██-████████--█-███-█████-█-████
-█-█-█-█---█-------█-----█---█-█-█---------█-█-█-------------█---█-█---█-----------█---█-------------
██-█-█-█-█-█████████-███---███-█-█-█-█-█████-█-█-██████--█-███-█-█---█-█-█-██-████-██--█---████████--
---------█-------------█---█-----█-█-█-----█---------█---█-█---█-█-█-█-█-█-█---------█-------------█-
-█████-█-███-█---███-█-███-█-█-█-█-███-█-██--███████-█████████-█-█-███████-█-██--███-█-███--██-██-██-
---█-█-█-█-█---█---█-█---█-----█---█-█-█---█---█-------------█-█-------------------------█-----█---█-
██-█-█-█-█-█-█-███-█---█-█-█-█-█-███-█-███-█-███-█-█--██-█---█-█-█-█-███-█-█-███-███-███████████-███-
---█-------█-█---█-█-█-█-█-█-█-------█-----█-------█-----█---█-█-█-█---█-█-----█---------█-----------
-█-█-█-█-███--████-█-███-███████-█-██-██-█-█--██-█-███-██--█---█-█-█---█-█-█-█-███-█-████--█-███-█-█-
-█---█-█-----█---█---█-█-------------█---█-------█---█-█---█---█-█---█-█-█-█-----█-█-------█-█---█-█-
██-███-█-███████-█-█-█-█-█-███-███--██---█-███-█-██--███-█-█-█-█-█-█-█████-█---█-███-███-█-█-█--████-
-█-█---█---------█-█-----█-----------█-█-█---█-█-█---------------█-█-----█-█-----█-----█-█-█-█-----█-
--████-█-█--██-█-███-█-█████--██---███-█-█████-█-█-█-█-█-█--██████----██-█████-█-███-█████-███-███-█-
-----------█---█-█---█-█---█-█-█-----█-█-----█-█-█-█-█-█-█---█-----█-█---█---█-█---------█-█-█---█-█-
-█-█-█-█-█--██---██--█-█-█████-█████-███-███-█-█-█-█-██-██-██--█-█-█-█████-███████-█-████--█-█-█-██-█
-█-█-█-------█---█-█-█---------█-█-█-█-----█-█-█-█-█-----█-█---█-█---------------█-█---------█-█-----
-███-█-█-█-███████-█--██-███--██---█-█-███████-█-█-█-█-███-███████-█-█-█-█-█-█-███-███-███---███-█-██
-█-█-█-█-█-------█---------█-----█-█---------█-█-█-█---------█-█-█-----█-█-█-█---█-█-----█-█---█-█-█-
-█-███-██--███-█████████---█████-█----██-███-█-█-█---█-█-█-█-█-█-███-█-█-█-█-███--██---█-█-█-█████-█-
-█-------█---█-------█---█-█-------█-------█-█-█-█-█-█-█-█-----------█-----█---█---█-█-█---█---█-█---
██-█-█-███-█-█-█-███-███-███-█████-█-████████████--█-█---██--█-█-███-█-███-█-█-████---████-█-█-█-████
---█-█---█-█---█-------█---------█---------------█---█-█---█---█-------█---█-------█---█---------█---
-█████-█████-█-█-███---███-█---███-█-█-███-██--█████-█-█-█---███--██-█-█---█-█---████--███-█████-█-██
-█-------█---█-█-█-----█---█---------------█-------█---█-------█---█-█-█-█---█-█-----█---█---█-█-----
█-█--█-█-███-█-█-███████-██-██-█-███-███-██--████-██-█-█-███-███-█-███-█-███-█-███████--██-█-█-█-█-█-
-----█-█---█---█-----------█-------█-------------█---█-█---█-----█---█-█---█-█---------█---█-█---█---
-█-██--█-█-███-█-█-███-█-█-█---█-███-█--██-████-█-██-██--█████-█-█-█-██--██--███-███████-█-█-█████-██
---█-----------█-█---█-█-█-█---█-----█---█-----█-█-----█-----█---█-█-----█---█-------█-------█---█---
██-███-█-██-██-█-████--███-█████---██-██-█-█████-██--███--█--███-█-█-███████-███-█-█-█-█-█-█-█-███-██
-------█-█-█-------█---█-------█-------█-█-----------█-------█---█---█-█---█-█-█---█---█---█-----█---
██-███-█-█-█-█-█-███-█-█-█---█-█-█-█████-██--███-██-██-█--██-█████--██-███-█-█-█-█████-█-█████-███-██
---█---█-----█-----------█-█-█-------█-----------------█---█-█-------█-█-------█-█-█-█-----█-----█-█-
-█-███---█-███-█-█--█████-██████-███-█-███-██---██-██--█-█-█-█-█-███-█-██--█--██-█-█-█--████---█-█-█-
-----█---█-█---█-------------█-█-█-█-----█-█-----█---█-█---█-█-█-█-█---█---█-█---------------█-------
-█-█-█-█-█-█-██--███-█████--██-█-█-█-█-██--███-█-████--███-███---█---█-█--██-███-█-█-█---█-████-████-
---█---█---█-------█-----------------█---------█-----█---█---█-------█-█-█---█---█---█-█-█---------█-
██--█----█████-█-█-███-███-█-████--█-█████-█-████----█-█████████---█-█████-█-█-█-█-█-█████-██████████
---█---█-█---█-█-█-----█---------█-█-------█-█-█---█-------█-█-----█-------█-█-█-█-█-----█-------█---
-█-████--█-█-█-█--██-█-█-█████-████--█████-█-█--██-█-███-█-█-█-█-█-███-████--█-███████--██-█-█████-██
-█-█-------█---█---█-█-█---█---█-█-------█-------█-------------█-█-█---█-------------█-----█---------
-███-█-█-███---█-█-█---█-█-█-██--██--█---█-█--██-███-█-███-█-█--██--██-█-█-███-█-█-██--█-█-█-█████-██
-█-█---█-█-------█-█-█-----█-------█-█-█-█-█-----█---█-█-█-█-----█---█-█-█---█-█---█---█-█-█-█---█---
██-█-███--█--█-███-█-███████--█████-█--████--█-█-███-█-█-█████-█-█-██-███--███████-███-█-█████-█---█-
-----█-------------█-----█-----------█-█-------█-█-█-----█-█-█-█---█---█-█-█-------█-█-█-------█---█-
-█████-█-█-█-█-███-██-████████-█-█-█-███-█████-█-█-█-███---█-███-███-███-█--██████-█-███-█-█-█████-█-
-----█-█-█-█-█-█-------------█-█-█-----------█-█-----------------█-----█---█-----------█---█-----█-█-
██-██--█████-█---█---████-██-███-█████-█-██-██-█-█-███-█-██-██--█--█-█-███-███-███-█-██--█---███-█-██
-----█-------█-█-█-------█---█---█-----█---█-----█-█---█-----█---█-█-█-█-█---█-█-------█-█-█-█-█---█-
-███-█-███-█-███-█-█-█-█-█-█-███-███---██-████-███████-█-█-███████-█████-█-█-█-███-█-█-█████-█-█████-
-█---█---█-█---█-█-----█-█-----█-█---------█---------█-█-----------------█-█-----█-█-----█-----------
████-█---█-████------███-███-█-█████-█-█-██-██-█-██-██--██████████████-███-█-█-███-█-█-██-██---████-█
---█-█---█---█---█-█-----█---█---█---█-█-------------█---------------█---█---█-----█-█-----█--------G
-█-██--█-█--████-██-██-█-█-█████-█--███--█---█-██--█--████-███-█-█-█████---█-██--███-██-████-██-████-
-------█---------█-----█---------█-----█-█-█-█-----█---█-█-█-█-█-█-█---█---█-█-█-█---------█---------
---██--███-████-██-█-█-█-█-███-█-███-██████--█-█-█-█-█----██-██-████-█-█████-█--██-███-█--██-█-█-████
---█---█---█-------█-█-█-█-----█---------█---█-----█-█---█-█-----█---█-█-█---█---------█-█---█-------
█--█-█-███████-█-███-█████-█-██--███-█-███-█-███████-█---█-█-██-██---███-█-█-█████-█-█-█-█---███-█-██
-----█-█-----█-█---█---█---█---█-----█---█-█-█-------█-------█---█-█-----█-█-------█-█-█---█-█---█---
██--██-███-█---███-█-█████-█-█--██---█-█████-███--██-███-███--██-█-█-█-███████-█████-█--██-███-█-███-
-----█-------█-----█-----█-█-█---█---------█-------█-█-----█---------█-------█-█-----█---█---█---█---
92 100