A█-█-------█-----█-█-█-------------█---█---█-------█---█-----█-█-█-------█---------------------------
---█-███---█-███-█-█-█-█-█████████-█-█-█---█-█████-█-█-█-█-███-█-█-███-█-█-███-█-███-█-█████████-██--
-----█---█-------█-█-█-█-----█---█-----█-----█-----█-----█---------█-------------------------█-----█-
--████---███-█-█-█-█-█-█████-█-███████████--██-██████--███-█-███████-█-█-█-███-███-█-█-███████-█████-
---------█-----█---------█-----█-█---█-----█-------█-----█-█-----█-█-█-█-█---█-█---█-█-█-------█-█-█-
██-█-███-█-██---████-█---█-----█-█-█████-█-█--██-███-█-████--█████-█-███-██-██-██--█-███-███████-█-█-
-------------█---------------█-█-----█-█-█---█---█---█-------------█-----█---█-----█-----█-----█-█---
█-█--█--██-█████-█-███████-█-█-█---██--█-█-███-███-█-█---█---███████-█████-█████-█-█--██-█-█-█-█-█-██
-----█---------█-█-------█-█---█-█-------------------█-----█-█---------------█-----█-----█---------█-
---███-████--█████-█████-█████-█--███--███-█-███-█████████████-███-███████-█-█-███--█████--█████-█-█-
-----█-█---█---█-----------█-------------█---------█-----------█-█-------█---█---█-█-█-----------█-█-
██-███-█-█-█-█████-█████-█-█-█-█-█-█-█---█-█████-███-█-███-███-█-██████-████-█-█--██-█-███-█-███████-
-----█---█-█-----█-------█-█-█-█-█---█-█-█-----█-█---█---█---█-----█---█-█---█-█-█-█-------------█---
-█-█-█-█████-█-███-██-██-██--█-█---███-██-████-█-█-█-█-███-█████-███-███-█-█-█-███-█-█-█-███-███---██
-█---█-------█-█-------█---█-█-------█-----█-----------------------█-------------------█-█-----█-█---
██----████-███--██-█-███-█-█-█-█-█-█████-███-█-█-█-█████-█-█-█-█--██-█--█-██---█████-███-███-█--██--█
-------█---█---█-----------------------------█-█-----█-█-█-----█-----█-----█-█-----█-------█---------
██--██-█-██-█--███-█-█████-█-█-█-███████-███-█---█-███-█--████-█-█-██--█-█-█-█-█-██-██---███-█-█--██-
-----█-----------█-█-█---█---█---------█---█-█-█-█---█-------█-█-█---------█-█-█-----█-█-------█---█-
-█████-██--███-███-███-███████---███████---██--█-█-█---███-███-█-███-████-████-█████████-███-█--█████
-----█---█-█---------------█---█---█---█-█-█---█-----------█---█---█---█-█-█-█---█-█-█-----█-█-------
██-███--██████---█-█-█-█████-██--█-█-███--██-█-█-█-█--█-██-█-█--██-█████-█-█-█████---███-██-████--███
-█-----█-█---█---█-█-█-----█-----█-----█-█-█-█-█-█-█---█---------█---█---------█-------█-------█-----
-█████---█-█████-███-█-███-███-█---█---█---█-███-██--██-████-███-█████-█-███-███-██-██████████-█---██
-█-█---------█-------█---█-█-------█---█-----------█---█-----------█-█---█---█-█-█-█---█---█---█-----
-█-█████-█--███--█-█-██----█-█████-█-██--█████-█████--██████████-███-█-███-███-█---█-██--███-█-███-██
---------█-----█-█-█---█-█---------█-█-------█-----█---█-█-█---█---------█-----------------█-█-------
██-█-█-█-█-█████---█-█-███--██-█-█-█-█-███-█-█-█████████-█-----█-█-███-█████--█-██████-█████-███--█-█
---█-█-█-------█---█-----█-█-█-█---█-█-█---█-█-------█-█-█-------█---█-------█---█-█-█---------█-----
██-█-██--███-█████--█--█-███-███-█-█-█-█---█-█---█-███-█-█---█-█████████████----██-█--██-██-████-█-██
---█-------█-----█---█-------█-█-█---█-█-█-------------------█-------█-█-----------------█-----------
-███-███-█-█---███-█---█-██-██-█-███-█-█-█-█-█-█████-██--███--██-█████-█████-█-█████-████-█--██-██--█
-█-█-------█-----█-█-----------█-----█-█-█-█-------------█-----█---█-█---█-█-█-█---█-█-----█-----█---
-█-███-█-███-█-█-██----█-█-███████-█-█-█-█-██--█--████---█--████████--██-█-█--██-███-█-███-█-██--█-██
-------█---█-█-█-----█---█-------█---█-█-█-█---█-----█-█---------█---------█-----█-------█-----------
-█-█-█--██-███-███-█---███-█-█████████-█-███---█-█-█████-█-███-███-███-█-███-████---███--█-█-█-█-████
-█-█-█---█---█---█-█-------█-------█---█-█---█-█-█-█-----█---█-------█-█-█-----------█-------█-------
---█-█-█--███--█-█-█--████-█-███████-█-█████-█-█-█-███████-█-█-███-█-█-███-█-█-███-███---█-█--██████-
-█-█-█-█---█---█-█---█-█-█-█-----█---█---█---█-█-█---█-----█-█---█-█-----█-█-----█---█-█-█-█---------
-█-███-███-█-█-█-███-█-█-█-█-█-█-███-██--█████----█-██-█-█-███-███████-███████-█-███--██-██-██-███-██
-█-█-----█---█-----█---------█-----█-█---█-----█-----█-█---█---------█-----█-█-█-----------█-----█---
-█-█-█---███-███-███████████-███-███-███--██-█-█-██-██████-███--██-█---█--██-█-███-█--███-██-----███-
-----█-█---█---█-----------█-------█-█---█---█-█-------█---█-----█---█---------█-------------█-------
-█-█-█-█████-█--█-█-██-█-█-█████-███-█---███-███-█-█████-█-███-███-███-█-█-███-███-█-█-███████---███-
---█-█-----█-█---------█-----█---------█-------█-█-----------█---█---█-█-------█-█-█-----█-----█---█-
-█-██--█-█-█-█-█-█---███-███---█-███--████-█-█████---███-█-█-█--███-██--██████-█---█-█-█-█-██████████
-█-█---█-█-█-----------█---█-█-█-█---█-----█-█-----█-----█---█-------█-------█---█-----------█-------
--█--█-██----█-█-█-█-██---█--█-█-█-███-█████-█-███-█-███████-█--██-█-█-█-█-█-███--████████-█-█-██████
-█---█---█-█-█---█-█---█-█-------█---█-█-█---█-█---█---█-----------█-█-█-█-█---█-------█-█-█---█---█-
█-█████----█-█--██-████-██-█-█████-████--███--███--█-███-███-███-█-█-███████-███--████-█-█-███████-█-
---------█-█-█-█---------█-█---█-█-█-------------------█-█-----█-█-█-------█-------█-----------------
-█-███---███-█-█--██-█-██--███---█████-█-█████-███-█-█████-█-███-█--██-█-█-█-█-█-███-█-█-██-██---█-█-
-█-----█---█---█-█-------█-----█-----█-█-█-----█---█-----█-█---█-----█-█-█---█---█-█-█---█-------█-█-
-███-█----████-█-███-█-██--█-███-███████-█-█████-█--██-████---██-█████████---██-██-██--███-█-█-█--██-
-█---█-█-----------█-█---█-█-----█-█-█-█-------█-------█-------█-█-█---█---------------------█-█-█---
--██████-████--███-█████-█-██--█-█-█-█-█---█---█---████-██████-███---███-███-██----█-███████----█-██-
-------------█-█-----█-------█-█-----█---█-█-█-█-█---------█---█-----█-█-█-----█---█-----------------
-███-█-██--███████-█-█-█--████-█-█-█-█-█████-███-█████-███-█-█-█-█████---█-███-█-█-███-█---█-█---███-
-█---█-----------█-----█-------█-█-█-█-----█-█-------█-█-█---█-------█-----█---█---█---█-█-█-█-█---█-
████-█-█-█-█-█████-██-██-███-█-█---█---█-█-██--█-█-█--██-███-█-█-█-█-█████-█-██--█-█-█-█-███-█-█-████
-----█---█-█-----------█---█-█-█-█---█-█---█-------█---█---█---█-█-█-█-█---█---█-█-█-------█---█-----
-█-█-█---█-█-█--████-███-█-█-█████-█-██--█-███-█-█████-█-█████-█-█-█-█-█-█---█-█████-███-█-██████████
-█-█-█-█---█-█-----█---█---█-----█-----█-█-█---█---█-----------█---█-----█---█-----█---█-█-█-█-█-----
-███-█----██-█-█████-█--█████-██-███████-█████-█-█-█--███----█-███-█-███-█--██--████-███-█-----█-██-█
-█---█-█---█-█-------█-----█-█-----█-█-------█-█-█-█-█-----█---█---█-----█---█-----█-----█-----█-█-█-
██-█-█-█-███████████-███-█-█-█-█-███-███-█-███-█---█---█-█-███████-█---█-█-█-█████-███-███-█-███-█-█-
---█-------------█-------█-------█-----█-----█---█---█-█-█-----█-█-█---█-█-█-█-------█-----█---------
-███-█-██--█-█-█-███-█-████--██-██-███-█████████-█-█--██-█-█-█-█--█--█████-█-█-----███-█-█-█-█-██--█-
-█---█-----█-█-█---█-█-█-----------------█-█-█-█-█-------█-█-------█---█---█-----█---█---█-█-█-------
-█-███---███-███--████-█-█-█----████████-█-█-█-█-█-█---███-█-█---█-█████-█-██████--█-█-█████-█-███-██
-█---█-█---█-----█-------█-█-█-█-█-----█-█-----█---█-------█---█-----█---█-----█---█---█-----█-----█-
██----████-██-██-███---█████-█-█-█-███████--███-██████-███---█████-██--█-█-███-█---█-█-█-█-█-█-█---█-
---█-█-------█-----█-█-----█-----------█---------█-█---█-█-█-----█---█-----█---█---█-█-█-█-█-█-█-----
-█-█-█████-█████-██████--███-█-███--████-█-███-███-███-█-█-█-█████--██-███-██--█-███-█-███-█-█-███---
-█-█-█---------█-------█-█-█-█-----------█-█-----█---█---█-█---█---------█---█-----------█-█-----█-█-
-██-████-█-███---█-█-███-█-██--█-█-█-████--█-███-█-█-█-█-███--████-█-████--█-█-███████-██-████---█-██
-█-----█-█-------------------█-█-█-█---█---------------█-------█---█-----█-█---------------█-----█---
-█-█-█-----█-███-████-██---███-█-█-█---███-█-███-██--█----█--███-█---█---█-███-███--██-██--███-█-██--
---█-------█-█-█-------█---█-█-█-█-█-█---█-█-------█-█-----█---█---█-█---------█---█-----█-█-------█-
-███-██--█-███-███████-████--█████-██----█---█-█-█-██-██-█-██-██-█-███-█-███-█-███-█---███-█-███████-
-█-------█-█---------█-█---------█-█-----█-█-█-█-█-----█-█-----█-█-█---------█---█---█---█-----------
-██--█-█---█-██████--█-█-███-█-█--██-█-███-██-██-████--███-█---█-█-----█-███████-█-███-█---█-███-████
-------█-█---------█-█-----█---█-█-----█-------█-----█---█-█-█-█---█-█-█---------█-█---█-█-█---█-----
██-██-██-----███--████-█████████-█-█-█---█-███-█-███-█-█████-█---█-█-█-----███-█-██-██---█-███-█-█-█-
---█-----█-█-█-----------------█-█-█-█-█-█-█---█---█-------█-█-█-█-█-█---█-█-█-█-----█-█-█---█-█---█-
████-█-██--█-█-█--------████-███-███-█-███-█-█----███████-████-█-███████-██--█-█--████-███-█-█-█-█-█-
-█---█-----█-█-█-----------█-----█---█-█-----█---------█-----█---------------█-█-----█---█---█-█-█---
-█-█████-█-███-████-██-█████████-█-█-█-██--███-██----███-███-███-█-█-███-█-███-███-███-█████-████████
---------█-█---------------------█---█---█---------------█-█-█---█-█-█---█---█-------█-----█---█-----
-███-█-█--██-█-███-███-█-█████-█-█-███-█████-█-█-█-███-███-█---███-███-█-███████-█████-█-███-█-█-████
-----█-█---█-█-█-█-█-------█-----█-----------█-█-------------█---█---█-█---█-------█-----█-----------
-█-█-█-█████-███---█-█-█-██-█-████-█-██--███-█-███-███-█-█-██-████-█-███-█-█---█-█-█-█-█████-█--██-█-
---█-----█-█-------█-█-█---------------█---█-█-█---█---█-█-------------█-----█-█-----█-----█-----█-█-
---███---█-█--████████-█-█████-█-███-█-█-███--██---████----█-█-█--████-█-███████-█-███-█-███-███-████
---█---------█-█-█-█-█-█-----█-█---█-█-█---█-----█-----█---█-█-█-----█-█-------█-█---█-----█---------
████-███████-█-█-█-█-█████-█-███-███-█-█-█-█-███-█---█████-███-█-█-███-█-███-███-█-█-█-█---█████-█-█-
---█-█-----------------------█-█---█-█-█-█-█---█-█-█-█---█---█-█-█---█-█-█-█---█-█-█---█-█-█---------
-█-█-███-█████-██--█--██-█-██--█████████-█-█████-███---█████-████-██-█--██-█████-███---███-█-███-███-
-------█---█-█---█-█---█-█---------█-----█-------█---------█-------█-------█-█-----█-█-█---------█---
-█-█-██--███-███-███-██-██---███-█████---█-█-█-██--█-█-█-█--████--██---█-███-███--██-█████-█--████-█-
-█---█---█-----------█-----█---█-█-----█-█---█-----█-----█-----█-█---█-█---------█G--█-----█-----█-█-
100 82