A█-█-█-█---------------------------------█---█---------------------█-█-----------█---█-█-------█---█-
-█-█-█-█---█---███████-██-██████---█-██--█-█---█---███-█-███-██--███-█-█--████████-█-█-███-█-██-██---
---------█-█-------█-█---------█-█-█-█-----█---█-----█-------------█-█-█-█-------█-█-█-----█-█-█-█-█-
██---█-███-█-████-█---██-███--███-███-██-███-███-█-█-██-██--████-█-█---█-███-████--███-████-█--█-█-█-
---------█-█-█-█-█-█---------------█-------█-----█-------█-----█-------█-----------█---█-█-█-█-----█-
---███-███-█-█-█---█-█████---█-█████-███-█---█-███-██--█-██----█-███-█████-███████-█-███-█-█-█-█-███-
-█---------█-------------█-------█-█-----------█-----█-█-█-----█-█-█-----------█-█-█-█---------------
-███---█--██-█████-█-███-█-█-███-█---█████-███-███-███████-█-███-█-█████-█-█████-██--█-█-█████-██-██-
-█---█---------█-█-█-----█-█-------------█---█---█-------█-█-----------█-█-------█-█---█---------█---
████--██---████--█-███████--█--███-█-█████-█-█-███-███-█-█-███-█-█-█-███-█-███-██--█--█-████████-███-
-------█-█-------█-----█-----█-----█-----█-█-----█-------█-----█-█---█---█-----█-------------█-█-█---
--█---█--█-█████-███-███-█████████-██████--███-█-█████-█-█---█-█-█-█-█-███-███-█-███████-███-█---█-██
-█-----█-█-----█-█-█---------█-█-█-█-------█-------█---█-█---█---█-█---█-----█-------█-█---█-█-█-----
-███-█-████--███-█-█-███-███-█---█-█-█████-█-██--█-█---██-██████-███████-██-█--█-███-█-███████-█-█-█-
-█---█---█-█-------█---█---█---█---------█-█---█-█-█-█-----█---------█-----█-------------█-----█---█-
-███---███-█-████-██-█████████-█-█████-████-█-██-███-███-█████-██-█-██-█████-█-█-███-████--██-██-█---
---------------█---█---█-█---█-------█-----█---█-█-█---█---█-█-------█---------█---█-----------█-----
███--█-█-███-██--███-█-█-█-███--█-████--██-█-█████-███-██-██-█-████-██-█--██-█-███-█-█-█-█████-█-███-
-----█-█-█-----------------------█---█---█-----------█-----█-----█---█-█-█-█-█-█-------█-----█-----█-
---█-█-█-█-███-█-█-█-█████-██--███-█-█---█-███-█████-█-█-█-█-█████-█-██--█-███-███-█-█-█-█████-█-████
-█-█-█-█-█---█-█-█---█---█---█-------█-█-----█-------------█-----------------█---█-█-█-----█-█-█---█-
██-█-█--█-█--███---██-██-█████-█-███-████--█-██████████████--█-█-███-███-█-████-██---██--███-█-████--
---█-█-█---█---█-█-------------------█-█-------█-------█---█-█-█-█---█-----------█-█-█-█-----█-------
██---█-█---███-█-██████--███-███-███-█-█----██-███-██-██-█-█--██████-███-█-█-█---█-█-█-█---███-█-█-█-
-█---█---█---█-------------█---█---█-█-------█-------------█---█-------█-█---█-█---█-----------------
-███-█-█-███-█----█-██-██-██-█-█-██--█--██-█-██---██-█-█--████-█-███-█---█-█-█-█████-█████-█-█████-█-
-------█---█-█-----█-----█---█-█---------█-█---█---█-█-█-----█---█-█-------█-█-----█---█-----------█-
-█-█--██-█████--██-█-███-███-█-█-██--█---█-█-█-███-█-███-█-█-█████-█-█---███-█████--██-█████-█████-█-
-█-----█-----█-█---█---█---█-█-█-█---█---█-█-█-█---█---█-█-█-█-█---█-█-█---█---------█---█-█-█---█-█-
-█-█-█-█-███--██-█-████-████--███-████████-█-███-█---█--█-████-█---██-█--█-███-██████---██--██--████-
-█-█-█-█-█-----█-█-------------█---------█-----█-█-█-█-----█---------█---█-----------█-----------█---
--████-█---█-█-█-███--██---██-██-█-█-█-█-███-████-█-████████-█-█-█████--██-████████-████-█-█-█-███-██
-█---------█---█---█-█-█-█-------█-█-█-█-█-█-------█---█---------█-----█-█-----------█-█-█-█-█-█-█---
██-███████-█-███-███-█-███-██--██-██-██-█--█---███-█-█-█-█████-█---█-███--██-████--█-█-██--█-█-█-████
---------█-█-█---------█-█---------█-----█-----█-█-----------------█-█-----█---█-----------█-█-------
-███-███-█-█--██-██----█-███-█-█-██--███████-███-███-█---███████---██-██-█████-██████--███---█-█-███-
---█-----█-█-█-----█-█-----█-█-█---█-----█---------█-█-█-----█-█-█---█-------█-█-----█---█---█-█---█-
-█-█-█-█-███--██-███-█-█-███-██-████-███████---█-█-███-█-█-█-█-█-█-██--███-█-███-█-██------█████-███-
-█-█-█-█---█---█-----█-----█-█-█-█-█-█---------█-█---█---█-█-█-------------------█---█-█-█-█---------
-█-█-█-█-█-███--████-█-█-█████-█-█-██--█████---█-█---███-█████-█-███-█████-███-███-█-████████--█--██-
-█-█---█-█---█-------█-█---------------------█-█-█---█-----█---█-█-----------█---█---------█-------█-
-███-█--██-█-█-█---█-█-███-███-█-█-███-█-███-████--█████-███---███---█████-█-█-█-███-█-███-██--█-████
-----█-█-█-█-█-█---█-█-----█-█-█-█---█-█---█-----█-----█-█-█-█---█---█-----█---█---█-█---█-█---------
---█-███-███-███-█-███-█-----██-██-█-█████-███-█-████--███-█-█-███-███-██-████-███---█-███████-█-█-█-
-█-█---------█---█---█-█---█-------█---------█---█---------█-----█---------------█---█-█-----█-----█-
-█-█-█████-███████-█-█-███-█-███████-█-██-██-█-█-██-----█-████-██--██████████--███-█-█-█-█████████-█-
-█-█-█-----------█-█-█---█-----------█-█-█-█-------█-------█---█---------█---█-------█---█-------█-█-
-█████████-█-███---███-███-█-██-██████-█-█-█-█--██-█-█-█-███-█-██-██████-█-███-█-██--█-███---███-████
---█-----------█-█-----█-█-█-█-------------█-█-█---█-█-█-█-█-█-------------------█---------█---█-----
█---██-███-█--██████---█-█-█-█-███-████████████--██-██████-███---█-████--███████-█████-███-█-█-███-██
-█-█-----█-█-------█-------------█---█-------------█---█-█---█-█-----█-----█---█-█-------█-█-█-█-----
-█-█-███-███-█-█--██---█-███-█-█-█-███-----████-████--█--█--████--██-█-█████-█████-█-███---██-████-█-
-------█-█---█-█---█-█-█---█-█---------█-█-█-----█---█-------------------------█---█---█-█-----█---█-
██---███--██-█-█-█-███████-█████████-█-██--█-█-██--███-███-███-█-██--█-█-██-████-█████-█████-█████-██
---█-------█-█-█-█---█-------█-----█-----------█-------█-----█-█-█---█-█-------------█---█-█-------█-
-█--██---█-█-█████-██████--███-███-█-█---███-█---█-█----██-████-██-██-█--████--█████████-█-███-█████-
-█-█---█---█-----█---------------█-█-█-█---█-█---------█-------█-------█-----█---█-----█-------------
-█-█-███-███-█████-█-███-█-█-█████-█████-█-███---██████---█-███--███-██-██-███████-█-███-███-███-███-
-█-█---█---█-------------█-█-----█-------█---█---------------█-█-█---█-█-----█---------█---█-----█-█-
-█-██-█---████████████-█-█████-█-███-█-█--████████-█-█-███--██-█-█-█-█-█-█-█-███-█-███-███-█-█-██--█-
---█-------█---█-----------█-------█-█-█---------█-█---█---█-----█-█-█---█-----------█-------█-----█G
-█-███-█-█---█-█-███-███-█████-██--█-███-███-█████-█████-███-█████-███-█-█-█-███-█-█████-█-█-█████-██
---█---█-█---█-------█---------█---------------█-----------█---█-------█---█---█-█-----█-█-----------
██-███-█-███-█-███-█-█-█--█--█-███-█--██-█████-██-████-█-███-███-██-██████-███-█-███-█████-███-█-█---
---█---█-█-█-----█-█-█---------█-------█-------█-█---█-█-----█---------█-█-----█-█---------█-----█-█-
██-███-███-█-██-█-██--██-██-█--█-█-███████-█-█-█-███-█-█-███-███-███-███-██----███-█--█-██-█-███████-
-----█-----█-----------------█-█-█-------█-█-█-----------█---█-----█-█---------█-----█-█-------█---█-
-█---█---█████████-█-█-███-███-███-██--███-█-██-██-█████-█-███-█--████-█████-███-█-███-█-███████--███
-█---█-█-------█-----█---█-█---█-----█-█---------█-----█-------█-█---------█---█---█-█-----█---█-----
██████-██--█--█--███-█-█-████--███-----███-█-███████-█-█-██-████-███-█-██-██-███-███-█-█-█-██--█-████
-----█-█---█-█---------█-█-------█-█---█---█-----█-------------------█-█-█-█-█-█-█-█-----------█-----
██---█-█-█████-██-██-████--█-███-█-█-█-█████-█---███-█-██--█████-███████-█-█-█-█-█-█-█████-█-███-███-
---█---█-----------█-█-----█---█-█-█-█---█-█---█---█---█-----█-█-█-----------█---------█-█-----█-----
-█--██-███-███-█-███-███--██-█-███-█-█████-█-█-█-█-███---███----██-███████████-███-█████-█-█████-████
---█---█-----█-█---█-█-█-█-█-█-█-█-█---█-------█-----█-█-█---------█-----------------------------█---
████-█---█-█-█-███████-███-█-█-█-█-█████--██-█-█-█-███████---███---█-█-█-█-█-█-███-█-███-██████-██-█-
-----█-█---█-█---█-█---------█-----█---█-█---█---█-------█-█-----------█-█---█---------█-------█-----
-█████--███-██-█-█-███-█████--██-█-███-█-█-██--█-█-█--██████████████-█-████--███████-█-█-█████---████
-█-------█-----------█-█-----█-█-█-█---------█---█-█-█-----------█---█-------█-----█-█-█-----█-----█-
-█-█-█-█-█-█-█-███-█-███--█--█-█-█-█-█-█--██-█-█-███-█-██--█-████-██-█-█-████--████████-██-██-██-█-█-
-█---█-█---█-█-----------------█-----█---------█---█-----█-----█-█-█-█-█-----------------█-----█-█---
-███-██-████--██--█--█-██--█--███--█-███-█-█-█-██--█-█-███-█-███-█-███████-███--██-███-███-█████████-
-----█-█-------█---█---█---█---█---█-█---█-------█-█-█-█---█-----------█---█-█-█-█-█-----------█-█-█-
█-██---█-█-█-█--██-███-████--█-█-███████-███████-█-█-█-█-█-█████████-██--█-█-█-█-█-███-█-███████-█-██
-█---------█---█-------█-█---█-----------█-------█-█---█---------█-----█---------█---█-█-------------
---█-█---█-█████-█-█---█---███-█-█████---█--████-███-███-███-█-█-██--███-██--███-████████--█-█-█-████
---█-█-█-█---█-----█-----█---█-------█-█-------█---█-█-----█-█-█-█-█-█-█-█---█-----------█-█-█-------
████-█-------███-█-█-█-█-█--██-███-█-█--█--█-█-█---███-█-███-█-█-█---█-█-███-█-███████---███-███-█-██
-----█-█-█-█-█---█-█-█-█-█---█-█-█-█---█---█---█-----█-█-█-█-█-█-------█-█---█-------------█-----█---
████-█-█-█---█-█-█-███-█-█-█-███--███-██-█-█-█--██-███-█---███-█-███-█████-█-█-█---███-█████-█████--█
-█-█---█-█-█-█-█-█-----█-█-------------█-----█-█-█---█---█-----█-█---█-█-█-----█-█---█-----█---------
-█-█-█-█-███-█████---████-██-███-█-█-█-█---███---█-█-███████---███-█---█--██-█-█████--███--███-██--█-
---------█-█---█---█-------------█---█---█-█-----█-------█---█---█-------█-█---------█-█-----█---█-█-
-█-██-██---██-██-█-███---█-█-█-█████-█--██████-███████████--█--█-███-█--██-███-██-██-█-███-█---█████-
-█-█---------█---█-█-----█---█---█-█-█-█---------------█---█-█-█-----█-----█-----█-█-█-█-----------█-
-███-----█-███-█-███--██-████---██-███████-█--██-███████-███-███████-████-██-----█-█-█-█-███--███████
-█---█-█-█---█-█-----█-----█---------█-------█---█-█-------█-█---------------█---------█---█---------
█--██--█-█-█-██-████---█████-█-█-█-█████████-█-█---█-█-█-█-█-███--██-█-█-█-██-████-███-█-███-█-██--█-
-----█-█-█-----█---------█---█---█---------█-█---------█-█-----█-------█-█-------█---█-█---█---█---█-
-███████████-█-█-███-----███-█-█--██-█--████████-█-█████-█-█-█████-█-█-███-█-█-█---█-███-███-███-█-█-
---█---------█-█---█-█-█---█-█-----█-█-----█-----█-----█-█-█-█-------█-█-----█---█-----█---█---█---█-
60 100