A--█-------█-----█-----█-----█---█-----█-█---------------█-█-█-█-█-█---█-█-█-█---█---------█-------█-
██---███████--██-█-█-███-██----██--█-███-███-█████---██--█-█-█-█---█-███-█-█---█████--█--███-█---███-
-------------------█-----█-█-█---█-----█-█-----█-------█---█-█-█-------█---█-█-█-█-----█-█-█-----█---
██--██-█---█-█-██--█--████-███-████---██-█-██-██-█-█████---█-█---█████----██-█-█-█---█████-█████-█--█
-----█-█---█---█-------------█-----█-------------█-█-------█---█-█-------█-------█---█-█-█-█---█-█---
-█-███-████--█-███-███-███---█-█--██-███-███-█---███-████--█-███-█-█████-█-█-████--█-█-█-█--██-█-███-
-█-█-------█-█-█-----█---█-█---█-----█-█---█---█-----█-█-----█-----█-█-█---█-█-█-█-█---█-█-----------
██-█-███-██--█████-███-███-█---█---█-█-██████--███-███-███-███-██-██-█--████-█---█-█-█-█-███-███---█-
---------█-█-█-----█-----█-█-------█-------------█-------------█---█---█-----█---█-------█-----█-----
-█████-█-█--██-█---█-████-█--███-██--█████---███-█-███-███-██-█--█████---███-█---█-█████████-███---█-
-------█-----█-█-█-----------█-----------█-█-█-█-█-----------------█-------█---------█---█-----█-█-█-
-█-█-█-█-█-█-██--██--██-████-█-███-████-████---█-█-█-█-██-███--█████-█-█-█-███-█--██-█-█-███-███-███-
-█-█-█-----█---█-█---------------█-----█---█---█-----█---█-------------█-█---█-█---------------█-█---
-███-█-███--█-███--██--█-███-█-█-████--█-███-███-██--█-█████-█-███---█-█-██--█-█-█---█-█-█-███-█-███-
-█---█-█---█-----█---█-----█-█-█-----------█---█-----█---█-█-█-█---█-█-█---█-█---█-█-█---█-----█---█-
-██--█████-█-█--██████-█████---█-█████-█--██-█-█-█-███████--██-█-███-███████-█-█-███-█-█████-█-█-███-
-----█-------█-█-█---------------█---█-█-------█-█---------█---█-█-----█-█-█-█-█---█-█-------█-█-█-█-
-█-█-██--██--██--███-█-█-█-█-█████-█-██--█-█-██████-█--███-███-█-█-██--█-█-███████-█████-█-███-█-█-█-
-█-█-█-----█---█-------█---█-█-----█-█---█-█-█-------█---█-█---█-----█-------------█-----------█-----
██-█-█-█-----█-█-███-██--█-███-███--███--█████-█-█----████----███-██-█-█-█---███--█-██-█-█-██-██-█-█-
-----█-█-█-█-------█---█-█-------█-█-█---█---------█-█---------█---█-█-█---█-█-------█---█---------█-
██-███-█-███-█-█-███-███-█████--██-█-███-█-█████--████-█---███-█-██-██-█----██-█-███████-███-█---█--█
---█-----█---█---------█---------█-----█-----█-----------█---█-----------█-█---█---█---█-----█---█---
-███-█-█-█---█-█████-███████-█████---███-███-█-████--███-█-██--███████-█-█---███---█-█---█-█-███████-
---█-------------█-█-█-█-█---------█-█-█-█-------------█---------█-█---█-█-------█---█-█-█-█-█-------
██████-█-█-███-█-█--██-█-█-█████-████---██████-█---█-████████----█-███-█████---██---████-█-█-█-██████
---------█---█-----------------------------█---█-█-█---█-█-█---█-------█---█-█---█-█---█-------------
-███-█-███-█-███-█-█--██---█---███-█-███-█████-███-█████-█-█████████-█-█-███-█████-█--████████-█-███-
-█---█-----█---█-█-█---█---█-█---█---------█-█-----█-█-------█-█-------------█-----------█-█-------█-
-█-█-█-█---█-██████--████--██--█-██████--█-█--█----█---████-██-█-███████-█-█-███-███---███-█-█-█-█-██
-█-█-█-█---█-------█---█-█-█-█-█-------█-█-----█-----------------------█-█-█-█-█-----█-█-----█-█-█---
-███-███-█-█---█-██--█-█-█-█-███-█-███-█-███████-███-█-█-█-█-█-█████-███--██-█-█--███-██-█-██-█---█-█
-█---█---█-█-█---█-------█-█-----█-----█-----------█---█---█-█---█-----█-----------------█-----------
-█-█-████--███-█--██-█---█-█-█-█-███-██--█-███---█████-███-█-██----█-█-█-███-█--██--█--██-██████-██--
-█-█-█-------█-█-----█-█---█-█-█-█-█---█-█---█-------█---█-█-------█-█-█---█-█---█-----█-█---█-------
██████-█-█-█-█████-█████-███-█-█-█---█-█-█-█████████-█-███-███████████-█-█-█-█-█-███-███-█-█-███-████
-█---█-█---█---█-------█-█---█-█-----█-█-█-█-█-----█-█---█-------------█-------█---█-------█-█-------
-███-█--██--████-█████-███-███-█--██-███████-█-████████-███--███████-█████-█-█---██--███-█████-█-█-█-
-------------------------█-█-------█-----------------█-------█-----█-█-█-█-█-█-█-█-█-------█---█-█-█-
██-███████-███--██-███-█████-█---█████-███-███--██-█-█-███-█-███-█-███---█-███████-███-█████-███-████
-----█---█-----------█-----█---█-----█-█-----█-█---------█-█-█-------█-█-█-----█-----█---------------
-----███-███-██-█--█-███-█-███-█-█-█-█-█████-███-█---█-█████████--████-█--██-███-██-██-█████-█--██-█-
---█-█-------------█-█-----█-------█---█-------█-█-█-█---█---█-----█-█-█---█-█-------█-█---█-█---█-█-
-█-█-█-███-█-█--██-███-----███-█-█-█-█-██--█-█-█████-----█-████--███---█-███-█-█-█-█-███-█████-█████-
-█-█-█-----█-█---█---█-█---█-----█-█-----█-------█-█-█-------------█-█---------█---█---------█---█---
-█████-----███--██-███-█---███-█-███-█-███████-██--███-█-████--█-███-█-███████--██████-███-█-█-█-████
-█-----█-█-------█---█-█-█-█-█-----█-█-----█---------█-█-----█---------------█---█-█-----█-----█-----
-███-██--█████-█-█-█-█-███-█-███-███-██--█-█-█-█-████-███--█--██-█-█-███-█-█---███-███-█-█-███████-█-
-█-█---█-----█---█---█-█---------█---------█---█---------█-█---█-------█-----█-----█-█-█---█-----█-█-
-█-█-█---██-███--███-███-█-█---███-█-█--█--███---███-█-██-██████-█-█-███████-█-█-██--███████-███--██-
-█---█-----█-█-----█-█---█---█---█-█---█-----█-█-------█---█---█-█-█-------█-█-█-----█---------█-█---
█--█-█-█-███-███-█-█████████-███-█-█-███-█-█-███-███-█-███---█-█-██--█--███--█████████-█-█████-██-██-
-----█-█-------█-█---█---█-----█-█-█---█-█-█-█-----█-█-------------█-█---█-------------------█---█---
-█-███-█-█-█-███-█████-█-█-█-█-█-███--██-███████-█-█---███-█-███-█--██-███-███-█-████████--█--████-██
-█-----█-█---█-------------█-█-█-------█---█-█---█-█-█---█-█---█-█---█---█---█-█-█-----█-█-█---------
-█-███---███-█-█-█████-█-████-█--█-███████-█--██-███-█-███-███-█---█-███-█-███-█-█-██-██-█-█-█-██████
---█---█-█---█-█-----█-------█-----------█-----█-█-------█-█-----█-----█-█-----█-----------█-█-----█-
---███-█-----█████-█████-█-█████-███-███-█-████--█████████████-███-█-███--██-██-█--██--█---█-█████-█-
---█---█-█-------█-█-----------█---█---█-------█---█-----█-█---█-------█-█-----█-█-█-----█-----------
-███---█-███-█-█-█-███-███-█-█---█-█-█-█-███-█-███-█-█-███-███-█-██████-██-█--█--█---█-█-█-██--██--█-
---█---█-----█-█-█-█---█---█-█-█---█-█-█-----█---█-------█---█-----------█-------█-█-█-█-█-█-█---█-█-
███--█---█----██-███-█-█-███-███████████-█-███---█-█-███-███-████-███--█-█-█---█-█---███-█-█--████-█-
-----█-█-█---█---------█-█-------------█-█---█-----█-------------------█-█-█-█-█---█-----█---------█-
-█-████--███-███---█-███---█-███-█████-█-█-█-█-█████---█-█-███-█-█-█-█-█---█████-█████-█████-███-█-█-
-█-█-------█---█---█-█-█-█-----█-----█-█-█-█-█---█-█---█-█---█-█---█-█-█-█---█-------------█---█---█-
-█-███-█-█--███████-██-█---█--██-█████████-█-█-███-███-███-█████--██-████-██-█-█-█-█████-█-█-█-███-█-
-█---█-█-█---------█-----█-█-█-------█---█-█-█-----█-----█---█-------------█-----█---█---█-█-█-█---█-
██-█-█-█---███-██--█-█-█-███-███-█-█-█-███-█----██---█-███-█████-█---█-███-█-███-█--██-█--███-██-███-
-----█---█-█-----█---█-----█-█---█-█-----█-█-█-----█-█-------█---█-█-█---█---█---█---█-█-------█-█---
██-███-███-█-█-████-██-█-████-██-█-███-█████████████-███-█-███████-███-███-█---█--█--█-████-█--██-█--
---█-----█-█-------█---█-----█-------█-------------█---█-█---█-----█-----█---█-█---█-█---------------
-█-█-█████-█-███-█████-█-█-█████-███████---█-███-███-██-████-███-███--██---███-█-███-███-█-██--█-██--
-█---█---------█-█-----█---█-------------█-█---█-█-------█---█-█---█-█---------█---█---█-------█-█---
-█-███-███--█████--█-█--██-█████-████-█-███--███-█-█-███████---███-███--██-█-█--█-█--███-█---███████-
---------█---------█-█-█-----█-█-----------█-----█-----------█-█---█-█-----█-----------█-█-█-------█-
-███-█-███████-██--█-█-█-█-█-█-█-█-█-███-███-█-█-█-██--█-█████-█-██--█---█--██-███--█--█-█████-█-█-█-
-█---█-----------█-█---█-█-----█-█-█---█---█-█-█-█-----█-----------█-█---█-------█-█---█-----█-----█-
██--███--█-█-████-██-█-█-█-█-█-█-███-███-█--██-██--█-█-█-████████-██-████--█-███--██--████-█-█-██████
---------█-------█---█-█-█-█-█-█-█---█-------------█-█-------------------█-----█---█-------█-█-------
-██--███-█████-█-█-█-█-███-███-█-█-█-███-█-█-█-█-███-█-█-███████-█-███-█████-█---███-█-█-███---█-█-██
-------█-------█-█-█-----█-█---█-█-█-----█-█-█-█---█---------█---█---█---█-█-----█-█-█-█---█---█-█---
██-█-█--██-█-█████---█-███-█-███-████--███-███-███-███-█-█--██-█---███-█------███--█-█-█-███████-█-█-
---█-----█-█---█-█-█-█-█-█-█-█-----█---█-█---█---█-█-----█-█-----█---█-█-█-█-------█-█------------G█-
---█-█-█-██-████-█--█----████-██---█-███-███-███████-██--███-█-█████-█---█--█████-█-██████-█-█---██-█
-█-----█-----█-------█-----█-------█-------█-----█---█-----------█---------█---█-█---------█---█-----
█--█-█-██████--█---███-███-█-███-███-███--███-████-█-█-█-███████-███-█-███-█-███-█-███----███████--█-
-----█-█---█---█---█-------█-█---------------------█-█-█-------█---█-█-----------------█---█-█---█---
-███-███--████████-█-█---█---█-███--█████-████-█-█--█--█-█-█---█--██-███-█-███████-███████-█-█-█-█-█-
-█---------█---█---█-█-----█-█---█-------█---█---█-█---█---█-█-█---█-█---█-------█-------█-----------
████---█-█---███-█-██████--█████-█--█--█---█-█-███-███---███-█-███-█-█-█-█-███████-███-█---█-█-█-████
-----█-█-█---█---------█-------█-█---█-----------█-█---█-█-------█-█-█---█-----------█-█-█-█-█-█-----
██-█-█--██-█-█-███-█-█-██------█--██-███-███-█-███████-███---███████-█-███-█-█-███-█-█-███-█-███-█--█
---█-█-------█---█-█-█-█---█---█---█-█-----█-------█-█-█---█---█-█-█-█-----█-█---█---█-█-█-█-█-█-█-█-
-█-███-███████-█-█-█-███-█-█-███-█-█-████--█-█-█-█-█-█-█████-█---█-█-█-███-█-█-██-██████-██--█-███-█-
-█---------█---█-█-█-----█-█-----█---█-----█-█-█-█-----█-----------█-█-------█-----------------█-█---
-█-█-█-█-█-███-█-█-█-█-██--█████-█-███---█-███-███-█████-█-█-█-█-█-███-█-█-█-█-█-█---██████--█-█-█-██
-█-█-█-█-█---█-█---█-█-█-----█---█-█---█-----█---------------█-█---█-█---------█-█---------█-█-█-----
--██-██--█-███-█-█-██--████--█-█-█-████--█-███-███-██----███-█-█---█-█-███-█-█---█-█-█████████-█-█-█-
---█-█-█-█---█-█---█-------█-█-█-█---█---█---█-█---█---█-█-----█-█-------█-█-----█-█-█-------█---█-█-
-█--██---███-███-█--██████-█-███---█████-█-███--██-███-█-███-█-█-█-███---█-█-█-███-███-█████----█████
-█-----█-█-----------█-----█---█-█-█---------█-█-----█---█---█-█-█-█---█-█---█---█---------█-█-------
82 98