A--█-█---------█-█-█---------█-█-█-█---------█-----------█---█-█-█-█-█---------------------█-█---█---
-█-█-█-███-█-███-█-███--███-██---█-█-█---███--██-███---███-█-█-█-█-█-███-█-███---█---█-███-█-█--██-██
-█-----------█---█-█-█-█-----------------█-█-----█-█---█---█-█-----█---█-█-█---█---█-----█---█-█-█---
-█---█---█-█-█--██-█-█-█-███-█████-███████-█████-█-█-███-█-█---█-█-█---█-█████-████-██--████-█-█-█-██
-----█-█-█-█---█---------█-------█-------█-█-----█---█-----------------------------█-----█-----------
-███-█---███████-███-█-███-█████-██---██---█-████-██████-██--██-██-█-███-██-██-█████-█--██-█-███-█-██
-█---█-█-----------█-█-█-----------█-█-----------█---------------█-█---------█-█-█-█-█---------█-█---
-█-█-█-█-███-███---█--██---█████-█-███-█-█-███-███-█-█████-█-███-███-███-███-█-█-█-█--██-█-█-█-█---██
---█-█-█-------█-█---█-█-----█-█-█---█---█---------------█---█-█---█-------------------█-█-█-█-█-█---
-███-███████████--██-█-█-█████-██--███-█████-█-█-███-████-████-███-█-███-█-█-█-█-███████-█████████-█-
-------█---█---█---█---------------█---------█---█-█-------------█-█-------█-█-█---█-----------█---█-
-█-█-███-█-█-██-██-█-█--██████--███---█████-█-█--█-█████-█-█-█-█-█-██-█--███--█--███-███████-██████-█
-█-█-----█-----------█-----█-----█-█-█-----█-█-█---█-----█---█-█-------█---█---█-█---█-----█---█-█-█-
-█-███-█-█-█---███--█--█-███-█-█-█-█-█-█████---█--██-█-█-█---███-█-██--███-█████-█-█-█-██-██-█-█---█-
-----█-█-----█---█-█-█-█-█---█-----█-----█-----█-----█-█-█-█-█-█-█-█-----█-----------█---------------
██---█-███-█--█-████-█████-███--█-██--████-█████-███████-█-███-█--██-█-█-█-█-████--█-█-█-███-███-████
-----█-█---█-----------█-------█---------█-----------█-----------█-█-█-█-█-█-----█-█---█---█-█-------
-█---███-█-███-█-██--███-█-█-█---████--█-█-█████████-█-█-█-█---███---█-█-███-█-██████-██-████--██████
-█-█---█---█-------█-------█-█-------█-----------------█-█-█---------█-█-█-----------█-----------█---
--██-███---███-█-█-████-████-███-█-█-███-█--██-██--█-█████-█-███-███-█████████████-███-██████--█-█-██
---█---█-█-█---█-█---------█-----------█-█---█---█-█-----█-█-█---------█---------------█-------------
-█-██-██-███-█-█-█-█------██-█-███-█-██████-████-█-█-█-█-█-███-█████-█-█---█-█-███-█-█---█-███-█---██
-------█---█-█-█-█-█-█---█---█---█-█-------█-█-█-█-------█-█---------█---█-█-█-----█-----█---█---█---
██-███-█-█-█-█-█████-█████-███-█-███-███████-█-█-█-██-██████-███-█-██--██---█████-████-█-█████-█-███-
-------█-█-█-█-█-----------------█---------█-█---█-------------█---------█-----------█-█-----█-█---█-
-█-█-█-█-█-█-█-█████---█████-█--██---█-█--██-█-█-███-█-█-█-███████-█████████████--████-███-█████████-
-█-█-█---█-█-------█-█-------█---█-█---------------█---█-█-------------------█-█-----█---█-█---------
████-█-█████-█-█-█-███-█-██---████-█-█---█-█--████████---████-███--█-█████████----██-█████-█--████-██
-----█-----█-█---█---█-█---█-----█-█-█---█-----█-----█-█-----------█-----------█-█-------█-█---█-█---
██-█-██████████--█-------███-█████-█-█-█-█-█---█-███-█-█---█-█-█-███-█-█---█████████-█████---█-█--███
---█-----------█-█-█-█-----█-------█---█---█-█-----█-█-█-█-█-█-------█-█-█-------█-----█-------------
-█-█-█-███-█████---█-█-█-█-█--█--███-███-█████-███-███-█-█-███-█-█-█████-█-█-█████-█--█--█-███-█-█-██
---█-█-----█---█---█---█---█---█-█---------█-----█-█---█-------█-█-----█---█-----------------█-█-█-█-
-█-██--█-███-███-█---█-█-█-█--██-█---███████----████-█-███████-█-█-█████-█---█-█-█-█-█-█████-███-███-
-█---█-█-------█-█-█-█-█---█---█---█-----█---█---█-█-█-------█---█-----█-█-----█-█---█---------█---█-
██-██--█-█-█-███-█-----█-███-█████-█-██████---████-███-█-█████-█████-███-███-███-█-███-█████-█-█-██--
---█---█---█-----█---█-█-█-----█---█-----█-----------█-█-----█-█-█-----█-█-----█-█-------------█-----
██-█-█---█--████-█-█-█-█-█████████-█--██████████--██-██--██████--███-█████-█████-███████-███-█-█-█-██
---█-█-█-█-----█---█-█-------█-------█---------█-█-----█---█-█-----█-----------█---------█-█-------█-
-█-███-███-█-██-██████-█-█-█-█-███-███-█-█-█-█████-█████████---█████-██████-█--█-█-█████-----█-██-█--
-█---█---█-█---------█-█-█-----█-------█-█-------------█-█-█-█-█-█---█-█-----█-█-█-----█-----█-------
-█-█-█-█--██-█-████-██-█-█-███-█---█-█--██---███-█-█████-█-█-█---███-█-█-█████-█-█-█-█---█-█-█-█-█-█-
-█-█---█-█-█-█-----█---█-█---█---█-█---█-█-█-----█-----█-------------------------█-█-█-█-█-█-█---█-█-
-███-█████-█-█-█-█-█-██████--█-███-███-█-█-█--████-█-██--███-██--██████--█---█-█-█████-█-███-█---████
---█---█-----█-█-█---------█-█-----█-------█---------------█-----------█-█-█-----█-----█-----█---█---
-███-███-█-█-███-██--█-█-█-█-██--█-█-█-█-█--█--█████-████-█-████--██████-███-███-█-█--████-██--███-██
-█-----█-█-█---█-█-------------█-█-█-█-█---█---------█-█-----█---------█---█-█-----█-----█-----------
██---█-███--██████████-█-█----█--███-█--██-█-█-█-█-█-█-███-███-█-█-███-█-███---█-█-█-█-███-█-█-█-████
---█-█---------█-------█-█-█---█-----█-----█-----------------█-█-█---█-----█-█-█---█-█---█-█-█---█-█-
-█-█--██-███-███-███-██-████████-███-███----██-█-███-█-███-█-█-█-██--███-█████-█---█-█-███-███████-█-
-█-█-█-----█-------█---------█-█-----█---█---█---█---█-----█---█---█-----------█-█---█-------█---█---
-█-██------█-█-███-█-█-█████-█-█-█████--█--█-█-█-███-█-█-█-█████-█--██-█████████-██-██-███████-███-██
-█---█-█-█-█-----█-█-█---█-------█-------█-█-█-█-█---█-█-------█---█-----------------█---------█-----
----██-█---█-███-█-███-█-█-█-█-█-███-█████---█-█-███-████---████-█-█████-███-███---███-█-█-█-███-████
-█-----█-█-----█---█-█-█-█-█-█-█-█---█-----█-█-----------█-----█-█---█-----█---█-█---█---█-█-------█-
██-█-███--██-█-█-███-███-███-███████-█████-█-█-█-█-█████-█---███-█-█-█-█-█-█---█-███-█-█--██-█████-█-
-█-█---█-----█-----------█-█-------------█-█-█-█-█-----█-█-█---█-█---█---█-█---█---█-█-█-█-----------
-█-█-█-███---█-█-███---█-█-█-█████-█--██-█-█-███-█-███-███████-█████-█████-███-███-███-███---█-█---█-
-█---█-█---█---------------█-█-█---█-----█-█-------█-------█-------█-----█-█-----█-█-█---█-█-█-█-█-█-
-█---█-█████---█-███-█████---█-████-██-█-█-█-█████-███████-███-███-█--█---██-███-███-█-█-███-██--████
---█-█-█-------█---█---█-█-█-----█-----█-█-█-█---------------█---█-------------█-----█-----█-█-------
██-█-███-█-█---█████-█-█-█-█████-██-██--██-█████-███-█-██--███-█-█-███-██--█████-█-█-█████-█--██--███
-------█-█-█-█---█-█-█---█-█-------█---█---█-█-------█-----█---█-█---█-█---------█-█-------█-█-------
███--█████-█-█-███-█-████---██-█-███-█-█-███-██-██-███-█-█-███-█████-█-█-█-███-█-█-███-█████████-█-█-
-----------█-█---█-------------█-█---█-----------█---█-█-█---█---------█-█---------█-█-█-█-----█-█-█-
-█---█-██-████-█-█-███-███-█-█-█--██-█-█-███-█████---█-█-█-█-█████-███-█████-█-█-█---███-█-█-██--█---
---█-█---------█-█-█---------█---█---█-█---█-------█-█-█-█-█-----█-█---█---------------█---------█-█-
-█---█-█-█-█-██████-██-----█-███-█-█-█-█-█--██---█---█-█-█-███-███-█-█-█████-█-█-█---███-███-█-█-█---
-█-█-----█-------█---█---█-----█-█-█---█-█-----█-█-█-█-█-█-█-█-█-----█-----█-█-█-█-█---------█-█---█-
---█-█-██-██-█-██--█████-█-███-██-████-█-███-█-██-████-█-███-█-█████-█-█-████-██-█████-█████-████---█
-█-█-█-------█---█-----█-█---█-█-█-----█---█-█-------█-----█-------█-█---------█-█-█-----█-----------
████-█-██████████---████-███████-█--█----█-██-██-█-█████---███-██--███-█████████-█---████--█-█-██--█-
-----█---------█---------█---█-----█---█-----█-----------█-█-------█---------█-------█---█---------█-
█--█-███-█████-█-███-█-█-█--██████-█-█-███-█████-███-███---█-█-█-█-███-█-█-███--██████--█--███-█-█-█-
---█---------------█-----------█---█-█---█-----█---█-█-----█-█---█-█---█-█-----█-----█---█---█-█-----
-███-███-█-█-███-█-█████--████-█-█-█-█-█--████-████-█--██████--███-██-██-█████-█-█████-█-███--████-█-
-█---█-----█-█---█-----█-█-█---█---█---█-----█---█-█---------█-█---█---------█-------------█-█-----█-
████-█-█-█████-█--█-██-███-█-█-███████-████-█-███--█-███-███-██-██---█-███-█-███-█-█-█-█----█--██-█--
-----█-█---█---█-----█-█---------█---------█-----█-█-█-----------█-█-----█-----█-█-█-█-----------█-█-
-███-███-██--█-███-█-█-----█-██-████-█---███-█-██--███--█-██-███--██-█-███-███-█-█---█-█-█████-█-----
---█-█---█---█-█---------█-------█-█-█---------------█---█-----█-----█-█-----█-█-█---█-------█-----█-
-███-█████-█-█---█████-██████-██-█-█-█-█--██-█-██--█---█-███-███████-█-█-█-█-█-█-█-█-█-█--██-█-███-█-
-█---█-----█---█---█---█-█---█-----█-█-█---█-█-----█-█-█-----------█-█-█-█-█-█-█-█-█-█-----█-█---█-█-
██-█-███-███--█---██-█-█-█-█-█--██-█-█████-███-███-█-█-███-█-███-███-█-█████-█-█---█--██-█-██-██-█-██
---█-----------█-█---█-------█-█-█---█-------█---█-----█---█-------█-█-█-----█-█-█-█---█-------------
██--████-█-█████-███-█---█-████--█-███--██--██--██-█-█-███-█-█-█-██--█---█---█-██-██-█-█-█-█-█--██---
-----█-█---█-------█-----------------█---█---█-----█-█---█---█-█---█-█-█-█-█-------█-█-█-█-█---█---█-
█--███-███-█-██--██----███-█-█-███----██-█-█-███--███--███-█-██--█-███-███-█-█---█-███-████-██-███-██
-------█-█-█-█---█---█-█-----█-█-█-█-----█-█-█---█-█-----█-█---█-█-------█-█-█-█-█-█---------█-------
██-█---█-█-███████-██-████--██-█-█-███████-███-███----█--█-█-██-██-██████--██--███---█-█-█-█-█████-█-
---█-█-█---█---█-█-----█---------█-█-█---█-----█---█-█---█-█---█-------█-------------█-█---█-----█-█-
██-█████---███-█-███-█-███-█-█████-█-█--██-█-████--█--██-█-███-███-█---███-█-------█-█████████-███-██
-------█-█---█---------█-█-█-█---------------------█-█-█-█-----█-█-█---█---█---█-█---------█G█---█---
-█-█-█████-█████████-█-█-█---█--████-█-███-███-█---█---█████-███-----████-█--██-████-███-███---█-█-█-
-█-█-----█-█---------█-█---------█-█-█---█---█-█-█-------█-█-█-----█-----█-----█-------------█-█-█-█-
██-█-███-█-███-███-█-█-█-███---███--███-██---█████-███-█-█-█-██████-██-█-███-█-█-█-█-███---███-█-█-██
---█---█-----█-----█-█-█---------█-----█-█-█-█---█---█-█-----█-------█-█---█-█-█---█-----█---█-█-█---
██--██-██--█-███-█-███-█████-█-█-█-█████-█-██--█-█-█████████-█-██--█-███-█-█---█-█-█-███-█-█-███████-
-█---█-------█---█-█-------█-----------█-------█-█-------█---------█-----█-█-----█-█---█-█-█-█-------
-█-█-██-██-█-█-█████-█-██--█-██-████-█████-█-█-█████-█-███-█-█---█-███-█-█-█-█-█-█-███-█---█████-█-█-
---█-█-----█-█-█---------█-█---█-------█-----█-----█-█-------█-█-----█-█-█-█-█-█-█-█---█-█-█-----█-█-
92 92