A------------█-------█-----█---------█-█-----█---█-------█-█-----█-------█-█---------█-█-█-█-------█-
--██-█-█-████--█-███-█-█-█-█-█████-█-█-█-█████-███-██-█--█-███-███-██████--█████-█████-█-█-█-█-█████-
-█---█-█---------█-----█-█-------█-█-------█-█-----------█-------█---█-█-█-------------█-█-█-█-█-----
-█-█-█-███-█-███-█---██-████-█████-█-██████--█---█████-█---██----█-█-----█-███-█-███-███-----███-█---
-█-█-----█-------█---█---------------█---------█-----█---------█-----█-█-----█-----█-------------█-█-
-█-██--███-█-█-█-█-█████-█---█-█████-█-█--█--█████-█-█--████-█-█-███---█--██████---████-██-█████-█-██
-----█---█-█-█-█---------█---█---█---█---█-█-----█---█---█---█-█---█-----------█-█---█-█-█-----------
-█-█████████-█--████████-██-██████-███-█---███-███-███████-███-█-████████-████████████-█-█-█████-██--
---█-----------█-----█-█-----█-█-█-█---█---------------█-█---█-----█-----█-------█-------------█-█---
-█-█-███████-███---███-███-███---█-█-█-█-██████--█-█████-█-█████-██--█-███-█████-█-█---███-█████-████
-█-------█-█-----█---------█-█---█-----█-█-█-█-█---█---█-----█-----█-█---█-█---█-█-----█-█---█-------
██-███-█-█-█████-█--██-█████-█--█--███-███-█---████--███-█-████████--█████----█-████-█-█-█-███████-█-
-----█-█-------------█---------------█-█-█-█-█---------------█---------█-------------█---------█-█-█-
██-█-█-███-█-███-█-███-█--██-█-██--███-█-█-█-█-█--██-█-██████--███---██-██-█-███-█-███-█████████-███-
-----█---█-█---█---█-█-█-█---█-----█-█-----█-------█-█---█-------█-----█---------------------------█-
---███-█-█-█-█-█-███---███-█-█-███---█-███-█-███-███--████-█-█-███-█-█-█-████--██-██-███-█████-█-███-
-----█-█-█---█---█-█-----█---------------█---█-█---█---------█---█-█-----------█---------█---█---█---
██-██--█████-█-███---█████-███-█-███-█-███-----███-█-███-█-██-████-█-█-█-█---███-█-██--██--█-███-█-█-
-----------█-----█-----█-█---█-█-█-█-█---█-█-----█-----------█-█---█-█-----█-█-█-----█-█-------█-█---
██-█-███-█-█--██-█-████--███-███-█-██-██████-███████-█-███-███-█-█---█-█---█-█-█-████--█--██-██--████
---█---█-----------█---█---█---█-█---------█-----█-█-█---█---█---█-█---█-----------█-█---------------
-███-███-███-███-█-███-█-█████-█-█-██-██--███████----█-███--██-█-█-█--█--█--██-████--█-█-█████████-█-
---█-----█-----------------█---█-------------█-█-█-█---█-------█---█-█---█-----█-█---█-----█---█-█---
-█-█-███-█-███-█-█---█-█████--██-█-█--██-█-███---█-█████-███████████-███-█-█-███-█-███-████--███-█-██
-█-█---█-█---█---█-█-█-----█---█---█-█-█-------------█-█-█-------█-----█-█-█---------------█-█-█-----
-█-█-█████-██--███-█-███████-█----██---█-█-█-█--█--███-█-█--██-███████-█-█-█-███-████████--█-█-█-████
-█-█-----█-█-----█-█-------------█-█---█-█-█-█---█---█-------█-█-█---█---█---█---█-------█---█-----█-
-█---███-█-███-███-█-█-███-█-█-██--███-█-█████---█-███-█-█-█████-█-███--████-█-███--██-████--█--██---
-█-----█-█---█-█-----█-----█---█-█-----------------█-█-█-█-█---█---█-------------------█-█-█-█-----█-
██-█████-█-█████-█-█-███-███-███-█-██--█--██-█-█-█-█---███-█-█---███-█-██-█████-██-█████-█-███---███-
-------█-█-█-----█-█---█-█-----█---█---█-█-█-█-█-█---------█---------█-█-------█-----█-----█---------
██-█-█-█████-███-█-█--█--█-█-█-█-███████-█-██████-██-█-███-█-█████████-█████-███-███████----██--██-██
---█-█-----█-█---█-█---█-█-█---------█---------█---█---█-█-█-█-█-█-----█---█-█-█-█---█-----█-----█-█-
-█-█-█-█-██--█-█-███-█-█-███-█-███-██--███-███-█-███-███--█--█-█-███-█-█-█-█---█-█-█-███-█-█-█-█████-
---█-█-█-█-----█-█---█-----█-█-------█-█-----█-█-█-█-█---------█---------█---█-------█-█-█-------█-█-
-██----███-█-█-█-█-███-███████-█-███-█-█-███-███-█-██-----█--█-███-█-███-█-█-█-█-███-█-█------████---
-█---█-----█-█-█-█-█-----------█---█---█-█-█---------------█-█-█---█-█-----------█-█-█---------------
-█-███-█---███-█-█-█---█-█--████-███-█-█-█-█-█-█-█-███-█-█-█-██--██-████---███-███-█-█---███---██████
-█-------█-----█-█---█-█-█---█---█-------█-----█-█-------█-----█-------------█-█-----------█-█-------
█-█--█-█-██-████-███-███-█-█-███-█-█--████-█-█████-█-██-████-█-██--█-█-██-██████-██-████-█-█-████--██
-----█---------█-█-█-█---█-------█-█-----█-█-----█-------█-█-█-█-█-█-█-----------------█-------█-----
-█-----█-█-█-███-█-███-███-█-█-███-█-█--██████-███-███-----█-███---███-█████████-█-█-█-███-█████-█-██
-█-----█-█-----█-----------█-█---█-█-█---------█---█---█---█-------█-----█---█---█-█-----█-------█-█-
--█----███-███---███-███-███-█████-███-███-████--█████-█-███-███-███-█-█---███-█-███--█████████-██---
-█---█---█-█---█-----█---█---█-█-█-█-█-█-------█-----█-█-█-----█-█---█-█---█-█-█-█---█---█-█---█-█---
-█-█---████-██-█-███-██-██-███---█-█---█-█-███-█-█-████-██-███-███-███████----████-███-███-█-█-█-█-█-
-█---█-------------█---█-------------█-------█-█-------█-----█-----------█-------█---█-------█-------
-██--█-█-███-███-███-██████--█-█-█-█-██-██---█-█-█-███-█-█-█-█-██--█████-█-███--██-███-██--█-██--██--
---█-█-█-----█-----█-----█-------█-█---█-------------█-█---█-█---█---█---█-█-------------█-█---------
---█-█-█-█---███-███████--████-█-█---██-████-████████-█████--█-████-██-█-█---█-███--██--██---█-█-████
-█---█-█-█-█-█---------█-█-----█-█-█-------█-------█---█---█-█-------█---█---█-----█-█---█-█-█-█-----
-█-█--███-███████--███-██-██-█████-█-█---███-█-█-██---█--███-█-----███████---█-█-███-█-█--██-███-█---
-█-----------------------█---█---█-█---█---█-█-█-----------█-█-█-█---█-█---█---------█-█---█-█---█-█-
-███-█--█--███-███-███-█████-█-█-█-█-█-█████-███-█-█--██-███-███-█-█-█-█████---█████-███---█-█-█-█-██
---█-----█-----------█---█-----█-----------█---█-█---█-█---█---█-------█---█-█---█-█-----█---█-█-----
-█████████-█-█-███-███--█████--█-███---█-█--████-███-█-█████--██-███-█-█-█████████-███████-██████████
-----------█-█---█---█---█-----█---█---█-█-█-------█---█---█-------█-█-------------█-█-------█-█-█-█-
-███-█-█---█████-█-█-██--████----█-█-███---█████████-█-█-███-█-██--█-█-█-█-█-█-███---█-███-███-█-█-█-
-------█---█-------█---█-------█-█-------█-----------█-----█-----█---█-█-█---------█-----█-█---█-█---
-█-███---█-███-█-█---█-████-██-███-██-██---███--██-█-███-█-███-█-█-█-█-███-█-███--██--███-████-█-█---
-█-------█---█-█-█-█-█-----█---█-█-------------█---█-█---█---█-█---█-------█-█-------█-█-█---█-------
████-█████-█----██--██-█-█-████--█-███-███---█-█-█████-███████--██--██-█-█-█-███-█-███---█-███-██████
-----█-------█---█-----█---█-------------█---█---------█-█---█---█-█---█-█-█---█---------------------
██████-███-██--█-█-█-███████-███--██-██████--█-█-█-█-█---█--█████--███-███-█-█-█---███-███████-██████
-------█-------█---█-----█---█-----█---------█-------█---------█---█-█---█-█-█-█-█-█-----------------
-█-███████-███--████-█-█-█████-█-█████-█-███---███-██--█-█████-███-█-█-█-███---█-█████-███████-█-█-██
-█-------------█---------█-█---█-------█---█-█-█-------█-----█-█---█---█---█-█---------------█-----█-
██-███-███--████████-█-██--███-███-███-███--█--███-█-███---█-████--██----███-██--██--█-█-█-█-███-███-
-------█---█-----------█---█-█---█---█-------█-█---█-----█-------█-█---█-------█---█-█-█-█-█-█-------
-█---█-█████---█-███-█-█-███-█-███████--██-█-███-█-█-█-█-█--█-██-█████-█--██████-███-███-█-█-███-----
---█-█-█-█-----█-█---█---------------█---█-█-█---█-█-█---█-------█---█-------------█-█---█-----█-█-█-
█-██-█-█-███-█--██-█-█-████--███-█-███-████--██--████--███-█---█-███----██-██-███-████-█-█--██--██-██
-----------█-█-█---█-------█---------█---█-----█-----█---█-------█-------█-------------█-█-------█-█-
██-█-█-█--████████-█-███-█-█--██-███-███-█-█-█---███-█---██--██---███-██-███-█-█████████-█-█-█-█████-
---█---█---█-----█-█---█-█-█-----█-█-█-----█-█-█---█-█-█-----█---█-------█-----------█---█-------█---
-██--█-█--██-█---███-█-█-█-███-█-█-█████-█████-███-███-███--████-███-█-█-█████-█-█-████--█-███████-██
-----█---█-█---█-----█---█-----█-------█---█-█---█---█---█-█-----█-█-█-█-----█-█-█-█-----█-----------
-█-███-█-█---███---█-█-█-█-███-█-███---█-█-█-█-█████-███-█-█----██-███-█-█████████---█-█-█-█████-█-█-
-█-█---█-█-█-----█-█-█-█-█-█-------█-------█-------------█-█-█-█-█-----█---█-----█-█-█-█-█-----█-█---
-█-███-█-█-█-█-█-█-███-███-███-█████-█-█-███-█-█-█-█-█-███-███-█---█---█-███-█████████-███-█---██--██
-█-█---█-----█---█---█---█---█-----█-█-----█---█-█---█-█-█-█---█-------█-------------█-█---█-█---█---
-█--██████-█████-█-███-█-█-█-█-███-██-██-█-███-█--████-█-█---█-███-█-█-█-██--███---█-█-██--███--███-█
---█---█---█-----█---█-█-█-█-----------█-█-█-█-----█-----█-█-█-----█-█-█-█-█---█---█-█-█-----█-------
-█████-█-█-█-███-██--███---█-█████--████████-███-█-█-█-█████-███-█-█-███---███-█-█-███-█-█--██-██--█-
---█-█---█-----█---█-█---█-------█-----█---█-----█-█-----█-█---█---█-█-----------█-█---------█---█-█-
-██--█-█-█-█████---█-███-█-███████-█-█-█-███-█████-█████-█-██--█-█-█-█-█-███-█-█-█-██--█---█-█-█---█-
---█---█-------█-█-█---█-█-█-█-----█-█-------------█---------█-█-█-█-█-----█-█-█-█---█-█-█---█-█-----
--█-██████-█-███-███---█-███-██-██-█-█-█-█-███---█--██---██--█-█---█-███-█-███-███-█-█████-█-█-█-█-█-
---█-------█-------█-█-█-------█-------█-█-█---█-------█---█-█-█-█---█---█-█---█-█-█-█-----█-----█---
██-█-████--█----█-----█--███-█████-█-██--███-███-█-███-█--██-██-█-█-██-█-█-███-█--██-█-███-███-█████-
-----------█-█---█-----█-█---------█-█-█---█---█-█---█-------█---------█-█---█---█---█-█-----------█-
██-█-█-███-███-███████-█████-█-███████---███████-███-███-█████-███-███-█-███-█-█-███-█-██--█-█-█-██--
---█---█-----█-------------------------█-█-█-█-----█---█-----█-█-█-█-------█-------█---█G--█-█-█-█---
-████--█-█-█--█-██---█--█-█████--█-█-█-█-█-█-█-███--█--█-████-██---███-█---███-███-███-███-███-███-█-
---█-------█-----█-█-█-----█-----█-█---█-----█---█---█-█-█-------------█-█-█---█---█-█---█-------█---
████-██-█-█----███-█-█-█-███-█-█-███-███-███-█-█████-███-█-███-█-███-█████-█-█-█-█-█-███-███---██████
-█---█-----------█-█-█-█---█-█-█-█-█-█-----█---█---█-█-█---█---█---------█-█-------█-█-█---█-█-------
-█-█---█-███-█-███-█-█-----███-█-█-█████████-█████-███-█-█-█-█-█-██--███-█-███-█---█-█-█████--██-█-█-
-█---------█-█-█---█---█-█---█-------------█-----------█---█-█---------█-█-█-█-█-------█-█-----█-█-█-
-█-█-███-███-█-███-█-█-███-█-██--███-█████-█-█-██-██-███-█-███-█-███-█-█-███-█-███-█-█-█-█████-█████-
---------█-------█-█-█---█-█---█-█-------█-█-█---------█-█-█---█---█-█-█-------█-----█-------█---█---
92 88