A----█-------------------------█-------------█---█---█-----█-------█-█-----█---█-█-------------------
-█-█-█-███-███-███████-███-████--█--█-█-█████--███-█-███-███-███--██-█-█-██--█-█-█-█-████-██--█-██-█-
-█-█-----█-█---------█-█---------█-----█-█-█-█---█---█-----█-█-█-█---------█-----█---█-█-█---█---█-█-
-███-██---████-█-███-█-█-█████-█████-███---█-█--██-███-█-██--█-█-███-█---█████-███-█-█---█---█-█████-
---█-------█-----█---█-█-----█---█-█-----█-----------█---█-█-----█---█-------------█-------------█-█-
---█----████-██--███████-███-█-███-██████--█-███---███-███-█████-█-█-█████████-█████--████-█-█████-██
-----█-------█---------█---█-█-----------█-█---█---█---█-█-█-----█-------█-█---█---█-----█-█---█-----
-██-████-███████-█---███-█████-████----███-█████-███-███-█-███-█████-█-██--█-█--██---████-██-█-█-█-██
-█-------█---█-█---█-█-----█-------█-█-█---█-------█-█-█---------------------------------------------
███-██-█-█-███-███--██-█-█████-█-███-███--████-█████-█---█-███--██████-███████-█---███-██████--█████-
-------█-------█-------█---█---------------------------------------█---------█-█---█-----------------
-███-█--████-████--█-█-█---█-█-█████--██-█-█-█-███-█-█████-█-█-█--██-█████-█-███████-███-███-███-██-█
-█---█-----█---------█-█-█-█-----█---█-----█-█---█-█---█-█-█-█-----------█-█---------█---█---------█-
-█-█-█--██-███-█-█-███-█-█████-███-█-█████-████--█-█-███-█-███-██--█-███████---█-███--██-█-███-███-█-
-----█---█---█-█-█-----------█---█-------█-----█-█---█-█-----█---█-█-------█-█-█-----█-------█-█-----
-███-█-███-█--██-███---█-█--██-█-███-███-█-█-█████-█-█-███-█-███-█-█████-███-██--███-----█████-█-█---
---█-█-█---█---█---█-█-------█-█-█-█-----█---█-█---█-----█-█---█-█-█-------█-█---█---█-█-----█-----█-
██-█-███-█-█-█-███-██-████-███-███-█-█-█-█-███-███-█-█-█---█-█-█-███-█-███-█-███████-██-██-█-█-████--
---------█-█-█-█-█-------█-----------█-█-█-----█-█---█-█-█-----------█-█-----------█-----█-----------
-█-█-█-█-█-█--██-█-█-██--███████-█---█---███-███-█-███████-███-█---█--██--████-███-███-█-█-███-█████-
-█-█-█-█---█-----█-█---█-----█---█---------█-----█---------█-------█-█---█---█-----█---█---█-----█-█-
████-█-█-███-█-█-█--██-█-███-█-██--█--██-█----█---██████-███████-█████-█-█-█-██████--███-█-█--██---█-
-----█-█-█---█-█-█---█-█-------█---------█-█-------------█-------------█---█-------█-█---█-----█-----
-█-█-███--████-███---█████-███-███-███-███-███-█████-█████-█-███-█-█-█-█-█-█-█-█████--████-█████-███-
-█-█---█-█-------█-█-----█---█-█-----█---█---█-----█-------------█---█-█-█---█---█---█-------█-------
-█-█-█-█--█--█-███-██████--█-███-██--█-███-█-█-█--██--█--███-█-█-███-█-████████--█-█-█-█-█--██-█-█-█-
---█-█-█---█-█---█-------------█---█-█---█-█-█-█-█-----█---█-------█-█---------█-------█-█---█-----█-
---█-███████---█-█-███-█████-█-█-███-█-███████--█--███---█-█--█████--█-███-█████-█-█-█████-█-██-██-█-
-█-█---█-----█-█-----█-----█-█-----█-█---█---█-------█-█-█-█---------█-█-█---█-█-█-█-------█---█-----
-█-█-███-█████-█-█-███████-█-██--█████---█-█-█-█-█--████-█-███-███████-█-█-███-█-███-███-█-██---██-█-
---█-█-----█---█-█---------█---█---█-------█-----█-------█-----------█---█---█-----█-█-█-█-█---█-----
-█-█-█-██-█-███--█-█-█████--████-█-███-█-███-█-███-█-███-██--█-█-███-█-█████-█-█████-█-███-█-█-█-█-█-
-█-█-█-------█---█-█-█-█---------█---█-█-█---█---█-----█---------█---█-----█-█-----█-----█---█---█-█-
-██--█-███████-█-█-█-█---██-█--█-████--███-█--████-█-█████---███---█-█-██████--█-███-██████-██-█-███-
-█-----------█-----█---█-----█-█---█-------█-----█-█-----█-█-█-----█-█---█---█-----█-----------█-█---
-███-█-█---█-█---███-███-█████-█-█-█████████-█--██-█████---█████---███-█--██-█-███-████████--███████-
-----█-█-█-█-█---█-█-------█---█-█-█-------█-█-█-------█-----█-█-█---█-------------------█-----------
██-█---███████-█-█---██--█████████-█-█-███-█-█-███-█-█---█-███-█-███-██-████████████-███--██-█-█----█
-----█---------█---█---█---------█-----█---█-█---█-█-█-------█-----█---█-----------█-----█-----█-----
-█-█-█-█-███████-█-█-█████-███-█████--██-██-██-█-███---███--████-███-█-█-█---███-███--█████-██---█-█-
---█---█-█---------------█---█-----------█-█---█-█-█-█-█---█-█-----█-█---█-█---█---------█-----█-█-█-
-██--████--███-█-█-█-█-██-████-█--█--███-█-█████-█-███████-█--███-██-█-███-█-█-█-███---██--█---█-████
-█-----█-------█-█-█---------█-█-█-----█---█-------------█---------█-█-█---█-█-█-------█-█-█---------
-█-█-█-█-███-█-█-█-█-█-█-█-█-█████-█-█-███-█-███-█-█-█████-███████-██--███-█-█--███-███----█████-███-
-█---█-----█-█-█-█-█-█-█---█-----█---█---█-█-█---------█---------█---█---█-------█-----█-█-----█---█-
-█-███-███-█--██-█-█-█-█-█████-██-██-█-█-█-█████████-█-███-█-█-███-███---█-█-███-█-██----█-███-█-█-██
-█-█-----█---------█-█-------------█-█---█---------█---█-----█---█---█-█-█-█---█-----------█-█-█-----
█-████████-█-███-█████-█-███████---█-█--██-█████-█████-███--████-█-████-██-█--█--█---█---█-█-███-████
-----------█-█-------█-█---------█-█-█---█---█-------█-█-------█-█-------█-----█---█-█-█-█-----█-----
██-█-█████-█████-███-███-█-███████-██--█-█-█-█-█-██-█--██--█-█-█-███-█████-█████-█---█--██-██████--██
---█-------------------█-█---█---------█-█-█-█---█-█-█-█-------█---█---------█-----█-█---█-------█---
██-█-█-█-█--█-██-█-███-█-█████-██-███████-███-██---█--████-████-█---████████-███-███-█-█████-█-█-███-
-█-█-█-█-------█-█-█---------------█-█-----█---█---------█---█-------------█-█---█-█---█-█---█-----█-
-██-██-███-█-█-███-█████-█-███-█████---█--██-█-█-██-██-█-█-█--████-█-█████-█--█----██--█-█---██-████-
-----------█-█---█-----█-----█-█---█---------█-█-----█---█-█-█-----█---█-█-█-█-------█-----█-----█---
-█████-█-██--█████-█---█-█----██--████---██-████--██-█-███-█-███-█████-█-█-█-█---█-█████---███---███-
-----------█-█-------█---█-█-----------█-------█---█---█---------█-█-█---█-█-█-█-█-█-----█---█-------
██-███--██-█-█-█-█-█-███████-██-██-█-█-█-█-██-██████-█-█-██-████-█-█-███-█-███████-█-█████████-█-███-
-------█-----█-█-█-█---█-----------█-----█-█-------█-█---█-------------█---------█---█-█-------█---█-
--█--█-----███---█-█-█████-----█---██-█-████---███--██-███-█-█---█---█-█████-███-█-█-█-█-████--██████
-█-----█-█---█-█-█-█-█-█-----█-█-█-------------█-█---█---█---█---█-█-█-----█---█-----------█-█-------
██-█-███-█-████--███-█-█-█-█-█-█-███-███---███-█-█-███-██████-█-██-█-█-█-███-█-█-█--██--██-█-███-██--
---█---█-----█-----█-------█-█-█-------█-----------█---------█-------█-█-----█-█-----█-█---█---█---█-
-███---███-█--████-█-█-█--████-███-█-██--█-██-██████-███-████-██-█████-█-█-█-█--██-██--███-█--███----
-----█---█-█---█-█-█-█-█-█-----█---█-█-█---------------█-----█---█---█-█-█-█-█---█---█---█-----------
-██--███-███-█-█-███-█-█-█-█---█-█-███--██████-█-█-█-█-█████--██-█--████-█-█-█-█-███-█----██-███-█---
---------█-█-█-----█-█-█---█-█-█-█-------------█---█-█-----█-----------█-█-█-█-█-█---█-█---█---█-█-█-
█--█-█---█-█-█-█-█-█-███████-███-----█-██████-████-█-█████-█████---█-█-█-█-███-█-████--███-███-██--█-
---█---█-------█-█-----█---█-----█-█---------------█-----█---█---█---█-█-█-█---█-------█---------█-█-
---█████-█████-████----█-█-███-███---██-█--█-█--██-███-█████-█-█-█-██-██████████-█---████----█-███-█-
-█---█-------█-█---█---█-█---█-█---█---------█---█---█---█-----█---------█-█---█-------█-█-█-█-------
█--███--██-██----████--█-██--██--█-█-█--████████████-███-█-█-█-█---█-█████-███-█████-█-█-███-████████
-----█-█-█-----------█-----█-█-█-█-█-█---█-------------█-█---------█---------------█-█-------█---█-█-
-███-█-█-███-█-█--█--█-█-█-███-█-███-█-█-█-███-█████--██-█-█-█--██████-█-██--█-████--█-███-█-█--██-█-
---█-█-█-----█-█---█-█-█-█-------█---█-------------█-------█-█-------█---█-█-█-----------------------
---█████-█-█-█-█-███-███-███-█-███--██-███--█--█-█-█████--██-█████████-█-█---███-█---█-█-█-█-█-███-██
-█-------█---█-█-----█---█---█-█-----█---█---█-█-------█-█-█---█-█-█-------█-█---█---█-█-█-█-------█-
██████-██--███-█-███-███████-██-██-██-███-██-█-███-██-████-█-███---█---█-██-████-███-█-█-███-█-███-█-
-------█-----█-█-█-█-----█-█---█-----------█-█-█-█---------█---------█---------█---------█-█-█-------
██-█--████--██-█-█-█-███-█-█-█████-██████-██-█-█-█████-███-███-███-█-███-███-█-█-███-█████-███-█-███-
---█-█-----█---------█-█---------█---------█-------█-----█---█-----------█---█---█-█---█-█-----█---█-
-█--███--█-█-█████-███-██-█--█-█-█---█---█--██--██--██-███████-███-███-███-███--██--██-█--██-█-█--█--
-█---█-----█---------█-----█-█-█-█---█-█---█-------█---█---------█---█-----█---------------█-█-█-█---
-███-███-████-██-█-█-█--█-██---███-█-███-███-███-█-██--██---██-████--█-███-█████--██-█-██---██████-██
-█-------------█-█-█-----█-█---█-█-█-█-----█---------█---█-█---------█---------█-█---█---█-----█-----
██-█-█-█-█-███-███-█-██-██-█-█-█-███-█-██-██-█████--██-█-███-███-█--██-█-█-███-█---███-█-███-███--██-
---█-█-----█-----█-█-----█-█---------█-------------------█-█-█-█-█-█-█-█---█---█---█---█-█-█-------█-
-█-█████--██████-█-█-█-██--█-█████--██-█-█-████-██-███-█-█-███-█-█---█--█-██--██████-█████-█---█-█-█-
-█---------------█-------█---█-█---█-█-█-█---------█---█-----█---█---█-----█---------------█---█-█-█-
██-█-█-█-███████-█-█-█-█---█-█-███-█--██--████-██--█-███████-█-█--██-█-█-██--███-███-███-█-███-█-█--█
---█-█-█---█-------█-----█-█-----█-----------█---█-------█-█---█---█-█-█---█-----█-----█-█---█-█-----
-█-█-█-█████-█████-███-█--██-█-█-██████--█-███-█-█-███-█-█-███-█-███-███████████-█-█-------█████-█-█-
-█-█-█-█-█-█-█-------█-----█-█-█-█-█-█-█-----█-------█-------█-----█-----------█-█-█-█---------█-█-█-
-█---█-█-█-█-███-█--██-███-███-█-█-█-█---█-██--█████-█-███-███---█---█-█-██--███-███-██████--█-█-███-
-█-█-----█-█-----█-█-----█---█-█-------█-█---█-----█-█-------█-█-█---------█-█-█---------█-----█---█-
-███-█-███-██--█---██--█--██████-█-███-█-█-███████-███-█████-█-█-█--██-███-███-███-████--███--██-███-
-----█-------█-█-█-----█-----█---█-█-----█-------█-█-------█-█-█-█-------------█-------█---█-█-█-█---
-█--██-█-███-███████-█-█████-█-█-█████-███-█-███-███-██--█-█-█-███-███-█-█-█-█-███---█-██--█-█-█--██-
-------█-------█-█-█-█-----█-█-█-----█---█-█-█---█-----------█---█---█-█-█-█-----------█-█G█-█-----█-
-██--███-█-█-█-█-█-███-████----███-█---███-███-██-██-█-█-███---█--██---███-█-██--██-██-█-███-█████-█-
-█-----█-█-█---█---------█---█-------█-------------█---█---█-█-█-█---█-█---█---█-----█---█-----█---█-
98 90