A------------█-█-█-█-------------█-----------█-----█-█---█-----█-█---------█-█-------█---█---█-----█-
-█-███-█-████--█-█-█-█████-█-███---█-███-█-███-███-█-███-█--██---█-█████-███-█-███--██--██-███-██--█-
-█-█-█-█-█-█---█-------█-█---------------------█---█-------█---█-------█-----█---█-----█---█-█-█---█-
-███-█-█---███-█-█-█-███---█--████-█-█-██████--█--██-█-███-█-█-█-█████-█--█--█-█-█-█-█████-█-█-█-██--
---------█---------█-----█-█-█---█-█-█-----------------█-----------█-█-█---█---█---█-█---█-------█---
-█-----███-█---█-█-███-███-███-███-█████-███-███-█-█-█-███-███-█-███-███-█-█-█-█-█████-█-███-███-█-█-
---█-------█-█---█---█-----------█-█-█-█-------█-█---█-------█-------█-█-----█-----█---█-------█-█-█-
---█-█---█-████-██-███-█-█-----██-█--█---█-█-█-███--██--██-███-█-█-███-█-███-██████--███████-███-█-█-
-█-█---█-█-------█-█-----█-█-----------█-█-█-█---█---█---------█-█-------█---█-█---------█---█-█-----
-█-███-███-█-███-█-█-█-██--█-█-███-███████████████-█-█-██████--██--█-█---███-█-█--█████-███----█-███-
-█---█---█-█---█-█-█---█-█-█---█---------█---█-█-------█-█-----█-█-█---█-█-█---------█-█---█-------█-
██-█-███-███-███-██--█-█-█--███-█--██--█-█-█-█-█-████-██-█-███-█-███-█████-█-█-███-███-█-██---███████
-----------█---█-█-█-█---█---█---█---█-█-------------------█---------█-----█-█---█-█-█-----█---█-█---
-█-███-███-███-█-█-█-█████--██-███-█-█-█████████-█-███████-█-███████-█-█-███-█-█████-█-█-█-█---█---██
-█---█---█---█-█-█-----█---------█-█-█-----█---█-------█-----------█---█---------█-------█---------█-
██-█-████--█-███-███-███-█-███-█████--█--███-█████-███-██-████-███-█-███-███████-█---█-███-█-███-----
-----█---█---█---------█-----█-----█---█---------█-----------█---█-----█-----█-█---█-█---█-----█-█---
██-██--███-█-█-█-█-█-█████-███-█---█---█-███-█-█-█-█-███-█--██████---█-███-███-█-█-███--██-███-█-█-█-
-------█---█---█-█-█-------█-█-█---█---█-----------█-█-----█-----█-█-----█-----█-█---█-------█-█-█-█-
██-█████-███-█-█-█-██--██--█-█--██-█-███-███-███████████████---███████-█-█-█-█-███-███-█-█-██--█-█---
-----------█-█-█---------█-------------█-----█---█-----------█---------█-█---█-█---------█---█-█-----
-███-█-█-█-█-█--██-█-█-███-█-█-█-█-█-███-█-███-██--███-█-█-█-█-████-█--█-█-███-███-████--███-███--██-
-----█-█---------█---█-█-----█-█-█-█---█-█---------█---█-█-█-------█---------█-█-------------█-------
█--█-█-███-█-█--█--█-█---███-█-███-███-███████-█-██--█████-█-█-█-█--██████-███-█-█████-███-█████---█-
---█-█---█-------█-█-█-█-█-----------█-------█-----------█---█-█---█---------------█-█---█-█-█-----█-
-███-█-█-█---█-██--█-█-█-█-█-██--█-██--███████-█-███-█████-█-█-█████-█-█-█-███-█-███-█████-█-█-█████-
---█-----█-█-█-----█-█-█-------█-█---------█-█-----█-----█-------█-█-█-----█---█---█-█---------------
--██-███-████----█████-███-█-██--█-███-█-█-█-██████-████-███---███-███████████-████--█-█-█-█-█---█-██
---█-█-------█-█-----█---------█-█-█-█-------█---------█---█-█---█-█---------------------█-----█-█---
█-██-█-█-█-█---█-█-█████--██-█-█-█-█-██████--█-█---████-████-█████---███-███-█-█-█-███-█-███--███--█-
-------█---█---█-█-█-█-------█-█-█-------------█---█---------█---█-------█-----█-█-█-█-█-█-----█---█-
██-█-█-█-█-████████--███-█-██████████--█-█--██-███-███-██--███-█-█-█████████-███---█-█---███-█-███-██
-----█-█-█---------------█-█-------█---█-█-█-█---█-------------------█-█-█-█---█-█---█-█---█-█-█---█-
██-█----██-█---█-███-███-█-███--████--█--█-█--█-████--██---█-█████-█---█-█-█-█-█-█-█-███-█-█-█████-█-
-----█-█---█-█-█-------█-------------█---------█-----------█-------█-------█-█-█-----█-█---█---█-----
-█-█-█-█-███-█-█████--██████-█████-███-█-█-█████████-█████████-██-██-██████--████--█---███-█████-█-██
-█-----█---█-█-█-----------█-----█-█---█-█---------█---█---█-█-█---█-█-█-█-█---█---█---█-------█-█---
-██--███-█████-█----██-█-█████-███-█████-█-█-█-██-██████-███--██-█--██-█-█-█-█-█-██-█████████--███-█-
-█---█-----█---█-█-----█-█-------------█---█---------------█---█---█---------█-█---█---------█---█-█-
-█-███-█-█-█--████-█-███-███████-█-█-------█-███-█--█--█-███-█-█-█████--██-███---███-█████-███████-██
-█-----█-█---█-----█---█-█-------█-█---█-█-------█-█---█---█---█-------█-----█-█-------█-------█-----
██-███████-███-█-███-█-█████-█--██-█---█-█-█-███-███-█-█-█-█-███--██████-████--██████--███-█-█-███-██
-----------------█---█---█---█---█-----█-█-█-█-----█-█-█-█---------------------█---█---█---█-█-------
-█-██-████-█-███████-█-█████-█-███---█████-█-███-----███-███-█-███████-█-███-█-█-███-█-█-███-█---██--
-█---------█---------█-----█-█-█-█-----█---█---█---█---█---█-█-----█-█-----█-█---█-█-█-----█-█-█---█-
-█-█-███--██-███████-█-█-██-██-█-█-██-████-█-█-█████████████████-███-█-███-█-██-██-█████--██-███-███-
-█-█---█---█-----█---█-█---------█---█-----█-█-----------------█---█-█---█-█-----------█-----█-----█-
-█-█-█-███-███-███████-███████-███-█-███-███-█-██--█----██-█-████--█-█-█-███████-█-███---████████---█
-█-█-----█---█---█-----█-█-----█---█-█-----█-------------█-█-----------█-------█-█-----█---█-----█---
-█---█████---█-██--█-█-█-█-█-█████████--█--███-█-█-█████--████-█-█----██████████-███-███-███--████-█-
-█-█-█-----█---█---█-█-----█-█-█-------█-----█-█-█-------------█---█-------█---█---█-----------█-█-█-
-█-█-█-█---█-███-█-█-████-██---█---███████--█--██--█████-█-█-███-███-███-█████-█-█████-███-█-███----█
---█-█---█-------█-------█-------█---█-------█---█-----█-█-█---█-█-█-█-------------------█-█-------█-
██-█-██-██-█-█---█-█████---█-█-----█-█-█-█-███████-████--██-█-████-████--█-██--█-█████-█-█████-█████-
-----█-----█-█-█-█-█---█---█-█-█---█-----█-----█-------█-----------█-----█---█-█-----█-------█-----█-
██-██-██-███-███-█████---██--█-█-█-█-███-█-█-█████-█---█-█---█████████-███-███████-███-█████--██████-
---------█-------------█---█-█-----█-█---█-█---█-█-█-█-█-█-█---█-█-█-█-----------█-----█-------------
-██--█████-███---███-████--█████-███-█-█████-██--███-█-█-█████-█-█-█-█---█-█-█-███-----█-███-█-███-█-
-█-█-█-----█---█-█-----█-------█-█-█-█-----------█---█---█-----------█-█-█-█-------█-█-----------█-█-
-█-█-███-███-███-█--█--█--████-█-█---█-███-███-█--████-███-███-█-█████-█-█████-███-█-█---███-█-█----█
-█-----█-█-█---------█-█-------█---█-----█-█-█-█---█-----█-█---------█-█---█---█-█-█-█-----█-█---█---
-███-███-█-█-█-██--█████-██--█-█-█---█-█████-█████--██-█████-█-█-█-███---███-█-█--█--█-█-███████████-
-----------█-█-█-------------█-----█-█-----------█---█-----█-█-█-█---█-█-------------█-----------█-█-
██-███---█-█-███-█-███-███-█████-█---█---█--████-█-█-█-██-██-█-█-███-█████-█-███-███-█-███-████--█---
---█---█-█-█---█-█-------█-----█-----█---------█-█-█-█-█-----█-█-█-█-----█-█---█-----█---█-----------
-█-███-█████-█-███-█-█-███-███--█--███-█████████████-█-█-██-█-██-█-█-█████-█-█-█████-█-███-█-███-██--
-█-█-----█---█-█---█-█---█---█-----█-------█---█-█---█-----█-------█---█---█-█-█---------█---█-------
████-█-█-███-███-████--█████-███████-█████-█-███-█---███-███-█-█████-██--███-███████-█---████████████
-----█---█-----█-----█-----------█-----█---------█-----█---█-█-----█-------------█---█-------------█-
██-█-██--██-█---██-█-███████-█-█-███-███-█-█--████-█-███-█-██-██--██--█████--██████--█████-█-█-█████-
-█-----█-----█---█-------█---█-----█-█-█-█-█---█-----█---█-----█---█-█-█---------█---------█-█-█-█-█-
-█-█-███-█████-█-███-█████-█--██-█████-█-███-█████-█--█-████-█-███-█-█-█-███-█-█-██--------█-███-█-█-
---█---█---█---█-█-█-----------█-------█-█-█---█-----------█-------█-█---█-----█-█-█-█-█-█-█-█---█---
██-███-█--██--██-█--███--█-█-███---█-██-██-█---█-█-█-█-█████--██-█████-█-█-█---█-█-█-█████-█-█-███-█-
-----█---█-----█-----█---█-█---█-█-█-------█---█-█-█-----█-----------█---█-█-------█---█-----------█-
-███-█-███-███-█---█---█-█-███████-█-█-█-█-█-█-█-█-█-█--████-█-███-█-█-█-███-█-█-███-█-█-█-█-█-█-█-█-
-█-█-█-█-█-█-----█-----█-----------█-█---█-█-█-█-█---█-----█-█---█-█---█---█---█-█---█-█-█-█---█---█-
-█-█-█-█-█---█-███-█-█-██████--██-██-█-█-███-█-█-███-███████-██--███-█-█-███-█-█-████-███-████-█-----
-█---█---█-█-█-█---█-------█-----█---█-█-----█-█---█-------█-█---█---█-█-----█-█---------█-----█-----
-█-███-██-██-█-██--███---█-█-█-███-███-█-█-███-█████-█-█████-█-█████-█-█████--██-███-█--████-█-█-█-██
-█---█-----█-█-█---█---█-█-█-█---█-------█-█-█---█---█-----█-----█---█-█-------█---------█-------█---
-██---██--██-█-██-█-██-███-█████████-███████-███████-█-█-██-██---███-██-█--█-███-██--███████-█-█-█-█-
-----█---█---█-------█-█-----------█-----█-------█-█-█-█-----█---------█---█---█---█-█---█---█-█-█---
-███-█-█-█---█-████--█---█-█-█--██--██████-███---█---████--█-█-█-█████-█-███-█-█-███-█-███-███-█████-
-█---█-█---█-------█-█---█-█-█-------█-█-----█-█---█-█-█-█-----█-█-----█-█---█-█-█-█---------█-█-----
-█---█---█--██-█--██████---█-█-███-█-█-█-█-██--███-█-█-█-█-███-█-█-█████████████-█----██████-█-███-█-
-█-█---█---█-----------█-█-█-█-----------█---█---------------█-----------█-----------█-------------█-
-██--█-█████-█-███-███-█████-█████-█████-█-███████-█-█-█--█-██--████-███-█-█-███-███-█-█-███-█-████--
-█---█---█---█-------█-----█---█-------█-█-------█-█---█---█-█-----█-----█---█-----█---█---█-█---█---
-█-█-███-█-█-█-███████-█---█-█-███-█-█-███---██-██--██-██--█-█--██████---██--█████-█-███████-█-█████-
-█-------█---█-█---█---█-█-█-█-----█-█-----█-----█-----------█-----█-----█-----█---█-------█-█---█-█-
--████---███---█-█-█-█-██████--█-█-█--█--███████-█-█-████--██████-██-█-█-█-█--████-█----█-██-███-█-█-
---█-----█---█---█-█-█-----█---█-█-█---█-------█---█---█-------------█-█---█---█---█-█-----█-----█---
██-█████-█-█-█-█-████--███████--████-█-█-█-███████-█-█-███-███-█-███-█-███-█████████-█-█-███████--███
-------█-█-█-█-█-----█-----------█---█---█-----█-█-█-█-█---█---█-----█-█-█-----█-----█-█-------------
██-█--██---█-█-█-█-███-█-█-███-███-█-███████-███-█---███-█-████---██████-█-███-█-█-███-██-██-█-███-██
---█-█---█---█-█-█-----█-█-█-█---█-█-------█-------█---█-█---█-----------█-█-█-------------█---------
-███████-█-█-███-███-███-█-█----█---██---█-█████-█-█████-█-█████--██-█-█████-███-█-███---█-█-█-█---██
-------█-█-----█---█---------█-█---█---█-█-----█-█-█-----█-----█-----█---█-------█---█-█---█G--█-█---
---███-█████---████--███-█-█-█-██-██---█-███-███-███--███------█-███-█-█-█--██-█████-█-█-███---███-█-
-------█-----█-█-----█-----█-█-█-------█---█-█-----█---█-----█-█-█-----█-----█-----█-█-█-----█-█-----
98 92