A--█---█-------------█---█-----█---█-------█-----█---█---█-------------------█-█-█---------------█---
--██-███-█████---█-███-█-███--██--██-██--█-█-███-███-███-█-█-███-█-██--███--██-█-█-███████-█-██-██--█
---█---█-----█-█-------█---------------█---█-----█-----█-------█-█---█-----█-█-----------█-█---------
-█-█-█-█-██------███████-████-██--██-███-███---████--█-█-██-██████-███-█-███-█-█-███████████-██-█████
-█---█-█-------█---█-----------█---█---█-----█-------█-█-----█-----█-------█-------█---█-█-----█---█-
---█████-█-█-█-█--█--█-█-██-████████-██--████████-██-███-█████-█-██---████---███-█-█-███---█-█-█--█--
-█-█-----█---█-█-█---------█-█-------------█-----------█-█-█---█---------█-----------█-----------█---
-█-█---███-███████-█-█-█-███---█████-███████-██-██████-█-█-███-█████--████-█████-█-█--████-█-█████-██
-█---█-█-█-------------█-█-----█-█-█-----█-----------█-█-------█-█---█---█-█-█-█-█-█-----------------
██-█-███-█-█-█-█-█-███-█-█-█-███-█-██-██-█-█-█████-████--███████-█-█-█----█--█-█-█-███-█-███-█████-██
---█-------█-█-█-█---█---█-█-█---------█---------█-█-------█-█---------█-█-------█---█-----█-----█---
██---█-█-█-█-█-██-████████-█-█-███-█-█-█-█-██-████-█-██-█-██-█-█-█-███-███----████████-███-█-█-█████-
---█---█-█-█-█-------------------█-█---------█-█-------█-█-----█-█-█-█-----█-----█-------█-█-█-█---█-
-█-█-███-█████-█-███-███-███-█-███-█-███-█████---███-███-█-███-███---███████--████-█-█-█-█-██--█-████
---█---█---█---█---█---█---█-------█---█-------█---█-------------------------█-----█---█---█-█-------
-██---██-███-███████-█-█████████--████-███-██--█-██████████-████-█████-█████-███-███-███-█-█-█--██-██
---█---█-█-█-█-█---█-----█-█---█---█---█---█-----------------█-------█-█---█-█-█---------█-----█-█---
██---████--█-█-█-███████-█-█--███-██--█--█-███-██-███-██-████--███-█████--██-█-█-█-███-██-█--█---█-██
-------------------█-------------█-█---█-█-█---█-█---------█---█---------█-█-█-█-█-------█-█-█---█---
██-█-█████-█-█-█-█-██--█-█-███████-█-█-█-███---█-█-█-███---█-█-█-█-█-█-█---█-█-█-█-█--██-█--██-█--██-
---█-█-█---█-█---------█-█-------------█-------█---█---█-█-----█-------█-█-█-█-█---█-█-█-█---█-█-█---
████-█-█-█---████--█████-█--██████████████-█████-█-██-████████-█-█-█-██-██-█-█---█████-█-█-█████-█-█-
---------█-█-------------█---------------------█-█-█-------------█-█---█-█---█-█---█---------------█-
-███-█-███-███-███-██--█---█████-█-█-█-█-███-███-██--██-██████-████--███-█-██----█-█--████-██-████-██
---█-----█-------█-█-----█---█-█-----█-█-█-█---------------█-█-█---█-█---█-----█---█-----█-------█---
██---██████████--███-███-████--█-█████-██--███-█-███-█████---███-█-█---█-██-██-█-█-█-███████-█-█-████
-------------█-----█---█-------------█---█---█-█-█-█-------█-█-----█-----█---█---█-----------█---█---
███--███-█-█-███-██--███-█████-█-█████████-█-████---██████---█-███-█-███████-█-█-█--█-█--█████-█---██
-----█-█-█-█---█-----------------█---------█---█-----█---------█-█---█---█-----█---█-█-█-------------
██-█-█-█-███-███████-███-████--██--█--██-███████-█-███-████-██-█-----█--██---█████-█-█--██-█-█-██████
---█-█-█-█---█-----█---█-----█-█---█---------█---█---█-----█-------█---█-█-█-█-----------█-█-█-----█-
██-█-█-███-█---█-███-█-█--██-█-█-█-█-█-███-███-█-█-█---█████--████-█-███-█-███---████-███--█-█-█████-
---█-----------█---█---█-----█---█---█-----------█-█-█-█-█-----█-█---------------█---█-----█-█-------
---█-█-█-███----█--███-█--█████--█-█-█-███-███--███--█-█-█-█-█---█-███-█-█-█---█-█-███-█-█-███-███-█-
-█-█-█---█---█-█-█-█-█-█-----█-----------█-█---█---█-----█-█---------█-█-█-█-█-█-█-█---------█---█-█-
-█-█████-█████---█---███-█--█-█--█-█-█-██---██-█-███---█-█-█-█-█-█-█-███-█████-██--█-█--████████---█-
-█---█-------█-------█-------█---█---█---█---█---█-█-█-█---█-----█-█---█-█-----------█-----█-█---█-█-
-█-█████-███-███-████████--█---█-█-█-█-█-█-█-█-█-█-█-███-█-███--██-██████--████--████--███-█-█████-█-
-█---------█---█-----------█-█---█---█-█-█---█-█-----█---█---█---█-------------█-----█---█---█-----█-
██-██-████-███████-█-██--██████-█--█---███████-█-█████████-█████--██-███-█-█████-███-█████-█-█-██-███
-----------------█-█-█-----------█---█-----█---█-------█---█-█-█---█---█-█---------█-----█-█-----█-█-
-███████-----█-█-███--█-████---█-█████-█-█████-█-█----████-█-█-█████-█-█████-█-███-█-█-██---██--██-█-
-█-█-█---█-█-█-----█-----█---█-█-----█-█-█-█-------█---█---█-----█---█-----█-█-----█-█---█---█-█-----
██-█-█-█-█-█-█-███-█-███-█████-█-███-█--██--██-███-███-███-█-█--██████████████-█-█-█-█---█-█████-███-
---------█-█-█---█-█-----█---------█-------█---█-----█---█---█-----█-------█-█-█-█-█---█---█-------█-
-█-█-█--████-████-██-█-███-███-███-█-█-█-█-█-█---█████████-█-██--███-█-█-██--█--█--█-█-█████-█████---
-----█---█---------█-█---█-█---------█-█-█-█-█-█---█-█---█-█---█-█---------------█---------------█---
██-██--███-█-█████-█████-██-██-█-█-█-█--███-████-█---█-██--█-█-███-██-█-██████████-█-█---███-███-████
---█---█---█---------█-█-----█-█-█-█-█-█-█---█-█-█-----█-█-█-█-----------------█---█-------█---█-█-█-
-██--█████-█-█-███-█-█-███-███-██--█-█-█-█-█-█--██-█-█-█-█-███-██-█-██---█-███-█-█--████-████--███-█-
-----█-------█---█-█-----█-█-█-------█-█---█-----█-█-█-------█-------█---█-------█-----█-----█-------
-█---███-██--█-█-███-█-█████-█-█-███-█-█-██--█-█---█-███████-█-█-█-█-███-██--█-█-█-█-███--█--█-█████-
-█-█-------█-█-------█-------█-█---------█---█-█-█-█---█-----█-█-█-█---█-----█-█---█-█-█---█-█-----█-
██-█-█-█-███-█-█████--████-█████-███-███-█-█-█-█-██--█--██-███-█-█-█---█-███-███-████----███-███-█-█-
---█-█-█-----█---█---█-------------█-█---█-█-█-█---█-█-----█-----█---------█---█-----------█-█-----█-
-███-████-----██-███-█-███-█████-█████-███-██--█████-█-█-█-█-██-████---█-█---███-█-█-███████-█--█████
-------█-------█---█---█-------█-----█-█---█-----█-█---█-█---------█-█-█---█-----█-█-----------------
-███████-█---█-█-█--██-███--█--███-███-███-█---█-█-█---█-█████-████--█-█-█-█---█-█-█-███-██--██--█-██
-█-----------█---█---█---█---█---█---█---█---█-█---█-█-----█-------█-█---█-█-█-█-----█-----█---█-█-█-
██-█-███-█-███-█-███-█-█-█-█-█-███-█-█--█-██-███-█-█-█-█-█-█-███-█-█-█-███-███-███-█-█-█-█-█-█-█████-
-----█-------█-█-----█---█-█-----█-----------█---█-█-█-█-█-------█-█-█-█---█-----█-█---█-----█-------
████-███████-█-███-███-███-███-███-████---██-█-█-█-███---█-█-██--█████-█-███-█-█-█-███-█████-███-███-
-------█-█---█---█---█-----█-----------█-█---█-█-----█-█---█-█-----█---█-█---█-█-█-█-------█---█-----
-███-█-█-███████-███-███--█-████---████--█████-█-███-█-█-█-█-█-█--████-███---█████-█--██-███-███-███-
-█---█-------█---█-----█---------█-----█-█---█-----█-█-█-█-█-█-█-----█-----█-----█-----█-█-█-█-----█-
-█-█-███-███-█-█-█████-███-█-█--████-█---█--██████--█████████-██████--██-████--█-█████-█-█-█-███-█-█-
-█-█---█---█-█-█---█-----█-█---█-----█-█-█---█-█-█---------█-------█---█---█---█---█-----------█-█-█-
-█████-█-█-█-█-██-██-███--█-██-█-------█-█-███-█-███---█-█-█-██--██-█--████-██-█████-█-█████-████████
---█-----█-█-█---█---█-----█-█-█-█-█---------------█---█-█-----█---█-------█---------█-------█-█-----
██-███-█-█--██████-█████-█-█-█-█████-█-█--█████████-████-█-█-███-████---██-█-████-█--█-███-█-----███-
-------█-█---------█-█-------█-----█-█-█-----█-----█-------█---█---------█-------█-█-█---█-█-------█-
-█-█-█---█-███-███-█-█-█---███-█-███-███--██-███-█-█-████████████-█--███████--████-█-███████-██-█████
-█-█-█---█-█-----█-█---█-█---█-█-█-------█---------------█-█-█---------█---█-█---█---█-----█---------
-█-█-█████--████-█-█-█-███-█-███-█-█-█████-███-█-██--█████---█---█-█-█-----███-█-█-█-█-██-█-████-█--█
---------█-█-------█-----█---█-█---█---------█-█---------------█-█-█-█-█-█-█-------------------█-----
██---███-███-█-█-███-███████---███-███-██-██-█-█████-█████-████-█-██-███-███-█-███-█-█-██████████-██-
---█-█-█---█-█-------------█---------█-------█---------█-█-█-█-█---█---█-----█---█-█---█-█-█---------
-█-███---█--████-███-███-█-█-█---█████-████-████-█-█-█-█-███-█-█-███---█-██-██--████-█-█---█-██--█-█-
-█---█---█-█-------█-----█---█-------█-█---------█-----█---------█-█-█-----█---█-----█---------█---█-
-█-██--█---█-█-█-█-█-██-█--█-█---███-███---█-----█-█-██--█-███-█-█-█-█-█-█-█████-███-███-████-██-████
-----█-█-█---█-█---█-----█-█-█-----█-----█-█-█-█-█-█-------------------█-█-----█-----█---------█-█-█-
-█-█-█--████-█-███-███████-███-█-███████-███-██-██-█-█-███-█-█-█-█-█-█-██--█-█-█-███-█-███-█--██-█-█-
-█-█-----█---█-█-----------█-█-█-------█---█---█---█-█---█-█-█-█-█-----█-█-█-█-█-█-----█---█---------
-█-█-█-█--████-███-███-███-█-█-███-███-███-█-█-█-█-███████-█-███-█-█-███-████-██-███--████-███-███-█-
-█-█---█-█-------█---█-------█---█-----█---█-█---------█---█-█-----------------█---█-█-------█-█---█-
██-█-█-█-███-█-█---██--█████---█-█-█████-█-███-███-█-██-██-█████████████████-█---████--█--██-█████-█-
-█-█---█-█---█---█---█-----█---█---------█---█-█---█-----█-----------------█-----█-----█-█-----█-█-█-
-█--██-█--███--█-███████-██-██-███-██--█-████-█-█-███--███-████████████-█----█████--████-███-█-█-███-
---------█-----█-█-----█---█-█-----█-█---█-█-█-------█-█-----------█---█-█---█-█-----█---█-------█-█-
██-█-███-█████-███-███-█-█-█-█-█-███--████-█-█-█-█-███-█-███-█████-█-█---█-█----█---████-████------█-
---█-----------█-----------█---█-█-------------█-█-█-█---█---█-----------------█---█-█-----█-█-█-----
-███-██---██-███-█-██-██-███-█████-█████-█-█-█-██-██-███-█████-█---█-█-█-█-██-████-█-█-█████-█--█--█-
-█-----█-----█-----█---█---█-█-------█-█-█-█---█-█---------------█-█-█-█---█-█-------█-█-█-█-----█---
████████---█-█--██-█-█-█-███-█-███-█-█-█-█████-█---███████-█---█-█-█-█---█-█-███--████-█-█-█-███-███-
---------█-█-█-█-----█-█-------█-█-█---█-----█-----█---█-----█---█-█-█-█-█---------█---█---█----G█---
-█-█-█--██-█---███---███-█---█-█-██--█-█-████████-██--██-███-███-█-███-███---███-█-█-█---███-█████-█-
-█-█-█-----█-------█-█---█-█-█---█-█-█-█-█-----------------█---█-█---█---█-█-█---█---█-------------█-
-██-████-█-█-█-█-███-█-█--█-██--██-█-█████-████████████-██-█-███-█████--██-█-█-█-███-█-█-█-███-█--███
-------█-█-█-█-█-█---█-█-█---------------------------------█---█-----█-█---█---█---█-█-█-█---█-------
██-█-██-██-█-███-█-█-█-███-███████--██-███████████-███---█-██--█-█-█--██-███----██-█-███-█-███-█-█-█-
---█-------█-█-----█-█---------------█---------█-------█-----█-█-█-█-█-----█-█---█-█---█-█-----█-█---
94 96