A------------█-------------█---------------█-█---------------█---█---█-█---------█---█-█---█-█-█-----
█--████--█████-██████████-██-█-█-███████████---███--██-█-█-█-█-███-█-█-█-█████-█-█-█-█---███-█---████
-------█-█-█-----█-█-█---█-█---------█-----------█---█-----█-----█-----█-----█-█-█-█-█---█---------█-
-███-████--█-█-█-█-█-█-██--█-███-███-█-█-███-█-█-█████--██-█--██-██-██-█-████--█-█-█-█-███-█-█-█---█-
---█---█-█-█-█-█-------█-------█-█-----█---█-█-█-█-█-█-----█-----█-█-█-----█-----█---------█-█-█-█---
██-█-█---█---███-███-███-█--██-███-█-█████-███████---█--████-█████---█--█-██-██-█---██████-███-█-█-█-
---█-----------█---█-----█---█-█---█---█---------------------█-█-------------------------█-█-█-█-█-█-
-███-█-█-█--█---████-██--█-███-█-███-█-███-█-█-██--██--█-███-█-█-█████-█-█-█-█-█-████████-██-███-█-█-
-█-█-█-█-█---------█-----█-----█---█-█---█-█-█-----█---█-█---█-------█-█-█-█-█-█-----█---------█-█-█-
-█-█-███████-██-██████-██-████-█████-█-█████-█████-█-█---█████-███-█--██-███-███-████--███-█-█-█████-
-█-------█---------█-█-█-█-█-------█-█---------█-█-----█-----█---█-█-------█---█---------█-█-█-----█-
████-█-█-█-█-█--██-█--█--█-███-██--█-█-█-█-███-█-█-█-█-█--██-█---█-███-█---█████-█-█████-█-███████-██
-------█-█---█-------------█-----█---█-█-█-------█-█-█---------█-------█-█-------█-------█---█-█-█---
-█-███-███-█-█████-█-█-█████---███-█-█-█-███████-█-█-█-███-█-███████████-█-█████--███████--██--█-█-██
-█---█---█-█-█-----█---------█---█-█---------█-----█---█-----------█---█-----█-------------------█-█-
-███-███-█████-█--██-█-█-█-█-█████-██--█████--██████---█-█-███-█████-███-███████-█-█-███-█---█████-█-
-█-----█-------█---█---█-█-█-----█-█---------█-█-----█-█-█-█-------█-----█---█-█-█-█---█---█---------
-███-███-█-█-█-█-█████-███---███-█-███-███-█-█-█--█--████--███-█████-█-███-███-███-█-█-█-----███-███-
-----------█-█-█---█---█---█-█-█-█-------█-█---------█-----█-█---------------------█-█-█---█-█-------
-███-█-█-███-██--█---█████---█-███████-███-█-███-█--████████-█---███████-█-█-█-█-----██████-█--███-██
-█---█-----█-------█---█-█---------█-----█---------------█-----█-----█-█-█---█-█---█-------█-█-------
███----█████-███████-███--██-█-█████-----███-█-██-█--█-█-█-██--███████--████-█-█--██-███-███-█-███-█-
-----█-------█-█-----------█-█-------█-----█-----█---█---█---█-----█-█-----------█-----█-----█-█---█-
████-█-███████---██-████-████████-████-█-█-██--█-█-█████-█████-█-█-█-█-███-███-█-█-█████-███-████████
-----█-------------█-█-█-----█-------█-------█-█---------█-█-------█-█---█-----█-█---█-█-█---------█-
-█-█-███-███-█---███-█-█-█████-█-█-███-█-█-████████-████-█-█-█-█-█---█-███-██--█-█████-█-█-█--██-███-
-█-█---█-----█-█-----█-------█-█-----█-█-█-------------█-------█-----█---█-█-█-█---█---█-█-█---█-█---
-█-█-█-█-███-███-██-██-███--████-███████-█-█---█---███-█-█-█-█-███-█-█-█-███--██-█-█-█-███-██--█-█-█-
-█---█-----█---█---------█---█---------█-█---█-█-█---█---█---█---█-----█---█-█---------█---█-█-------
██-█-█-███-█-█████--██████-███-█-█-█-█████-█-███-███████-█-██--███-█-█-█████-█-█-██-█████-██-███-█-█-
---█-----█-█-----█-------█-█---█---█---█-█-█-█-█---------█-█-----█-█---------------█-█-█---█-----█-█-
-█-██--██--█-█████-█-███-█-█-███---█████-███-█-███-█████-█-█-█-████--███-█-█████-███-█-███-█-███-████
-█---█-█---█-----█-█---█---------█---------█---█-█-█-█-█-█-█---█-----█-█-█---█-█---------------█-----
██-███---█-█████-█-█--██████-█-█-█-██-██-█-█-███-█-█-█--█-██--██-█-█-█-█-█████-███-████--█-█-█████-█-
-------█-█-----█-█-█-------█---█-█-----█---█---█-----------█-------█---█---------█-----------█-█-█---
--██-█████-█-█-█-█-█--█--███-█-███-█████-█-███-█-█████-███-----█████-███-██--███-███-█-█-███-█-█-█-█-
-█---█-----█-█-█---█-----█---█---█-█---█-█-------------█---█-█---█---------█-█---█-█-█-█---█---------
██-█-█---█-███-█-█-█-█-█-█-█-█-████--█---█-█████-███-██--███-███████-█-██-████-█-█-██████--█-██--█-█-
---█-----------█-█---█-----█---------█---█-----█-----█-----█---█-█---█-█---█-█---█-------------█---█-
-███-███-███-█-█-███-█-█-█-███-███████-█-███-█-█-███-█--█--█-███-███-███-█-█-███-█-███-██--████████-█
-█-----█---█-█-----█-█-█-█-█---------█-█-█---█---█-█---█-------█---------█-█-█---█-█-█-----█---█-----
--██-█-█-███-█-███-█████-█████-█-█-███-███-██████--█-█--█-███████-█-██-████--███-█-█--██-█-█-███-█-██
-█-----█-█-------█-----█-----█-------------█-------█-█---█-█-█-█---█---------█-█-----------█-----█-█-
-█---███████-█---█-█-█---█-█-█-█---█-█████-█-██-██-█-███-█-█-█---█---█-███-███-█-███-█-█-██--█-███-█-
---------------█-█-█-█-█-█---█---█-------█---█---█-█-------█-------█-------------█-----█-------------
███--█---███-███-██-████-█-█-█-█████-█--█-██---███-█████-███-█-█--█████--█--███████-██-█-█-█-██-█████
-------█---█-█---------█-█-█---█-█-█-█-█-------------█-█-----█-█-------█-█---------------█-------█-█-
-███-███-█-█--██████-███-███-█-█-█---█-█---█-███-█-█-█-█-█---█-█-███-█-█---███████-███-█-█-█████-█-█-
-------█---█---█-----█---█---█-----█-█-------------█---█---█-█-█-------█-█-----█-█---█-█---█---█-----
██-█---███---█-█-███-██--███-███-█-███-█-██--█-███████-█-█████████-█-█████-█-███-███-█████-█-██--██--
-----█---█-█-----█-------█---█---█-------█---█-█---█-------█-█---█-█---█-█-█-----------█-------------
--██---█---███-█-█---█-███-███-█-███-███-█-███████-█-█-█-█-█---█-█--██-█-█-███---█-█--██-███----█████
-█---█-█-█---█-█---█-----█---█-█-█-----█-----█---█-█---█-------█-█---█---█-----█-█-------█---█-------
██-█-█-█-█-███████-█████-█████-█-██--████--███-██--█-███-███-█-█████-█--██---███-█-█-█-█-█-█-█-█-███-
-----█---------█-----------█-------------█---█-----------------------█-█---------█---█-█-█-█-█-------
---█-█-█████████-█-███████-█---█-█---█████-███--██-█-███-███████-███-█-███---████████-████---█-██--██
---█-----------█-█-----█---------█-█-------------█-----█-----█-█-----█---█-------------█---------█---
-█-█-█-███-█-█████-█████-████-██-█-██-█--█---███--██---███-█-█-███-█-█-█-███--██-██-██--██-███-███-██
-█-█-█-----█---------------------█---█---------█-█-█---█-----------█-█---█---█---------█-█-█---------
██-----█-█-█-█-███████-█--██-█████-█-█████████--██-███████-█-█-███████-█-███-██--█-█--██-█-███-█-███-
---------█-█-█-█-------█-█---------█---------█-█-----------█-█-------█---█-----█-█-█-----█---█-█---█-
-█-███-█████-█-███-███-███-█-█-█-█████-█-█-█-███-███-████████-██-█-███---███---███---█-█████--██-████
-----------█-█-█---█-----█---█-█-------█-█-█-------█-----------█-------█-█---------█-█-----█-█-------
█--█---█-███████-███--██-█████-█-██--█--█--██-███----███-█-█-███-█-█-█-███----████-█-███████-███-█-█-
---█-█-----------█---█---█-----█---█---█-----█---█-█-█---█-----█---█-█---█-------█-█-----█-----█---█-
███---██-█--█--███-█████--██-██-██-█-█████-█---███-█-█-█-███████████-█████-█---███---█-█-███--██-███-
-------------█---█---█---█-----█-------█---█-----█-█-----█---█-█---------█-█-----█-█-█-----█---█-█-█-
██-█-█-█-█-████████--██--█-█-██████----█-█--██████-███-███-██----███-█-██-██-███-██--█████-█-█-█-█-██
---█-█-█-█-------█-█-█---█-----█-----█---█-----------█-------------█-█-----█-------█-----█-█-█---█---
-█-█-███-█-█-███---███--████-█-█-----█-███-█████-█-█████-█-█-██--█--██-█---███-████████--█████-███-██
---█---█-█-█-------█-----█---█-█-█-█-█---█-------------█-█-----█---█---█-█---------------------------
-█-█-█-███---█-█-█████████-█-███████-█-█████-█---█████-█-██--█-█-█---█-███-█-██--█-█-█████████-█-█-█-
-----█-█-----█-█-█---█---█-----█-----█-----█-█-----------█-█-█-█-█-█-█-----█-█---█-------█-----█-█-█-
██----█--█-█-█████-███-███-███---█████-█-███-█-█-█-█-█████-█████████-███-█-█-███-█-█-███-█-█████-█-██
---█-█---█-█-█-█-------------█-█-----------█---█---█-----------------█---█-----█-█-█---------█---█---
██-███-███-█-█-███-█-█-█████-███-█-█-███-███-█-█-██---████████████-█-███-█-█--████-███---█-█-█-█-████
-█---█---█-█---------█---█---█-----█---█-----------█-------------█-█---█-█-█---█-------█-█-----█-----
-███---███-█-███---█-█-----█--█--███-███-█-███---█--██-█---█-████████----█-█-██-██████████-███---█-█-
-----█-█---█-█-█-█-█-█-█-█-█-----------------█-----█-█---█-█-----█-----█-█---█-█-█-------█---█-█G█-█-
██-█-█-█-█-█-█-█-█-█████████-█-███-█-███-██--█-█---█--████-██---██--██---█-██--█---███-███-█-█-█████-
-----█-█---█---█-█---█---█---█-----█-------█---█-█-----█-----█---█-----█-█-------------█-█-█---█-----
-███-██--█-██--███-█-█-█--████--██-█-███-█-█-█-███-█-█████--██-█-█-█---█-█-█-███--██-███-█-█-█---█-█-
-█-█---█-█-█-----█---█---█-----█-------█-█-----█-█-█---█-█-------█-█-█-█-█-------------█-----█-█-█---
-█-█-█████-█-███-█-███-███████-██-████--██-█---█-█-█-█-█---███--█--█-█-███-█-██-██-███-█████-███---█-
-----█-----█---█---------█-------------█---------█-█-█---█-█-█-------█-----█---█-█---█-█-█-----█-█-█-
-█-███-█-█---█---█-█--██-█████-█████████████-█-█-███-████-██---█---█---███-███-█-█-███-█-█-███-██--█-
---█---█-█-█-█---█-------█---------------█-█-█-█-█-------█---█-█-----------█-----█-█-----█---█-----█-
-███-█-███-█████-█-█████-█-█-█-█-███-█--██---█---██-██-███-█████████-█████████---█-█-█-█-███████-█-█-
---█-█-█---------█-----█---█-█-----█-█-█-█-█-█-█---------------█---█-----------█---█-█-█-----------█-
-█-█-███-███-█-█-███-█████---█-█---███---█-█████-█-█-███-█-█-█-█-█-█-█-█-███-█-█-█-███-███--████-█-█-
-----------█-█-█-----█-----█-█-█-█-------------█-------█-█-------█-█-█-█---█-█-█-----█-█---------█-█-
-█-███-█-█████-███-█---████-------██---█-█-██-██-████--████----█-█-███-████-██---███████-███---█████-
-█---█---█-------█-█---------█-█---█-█-█-█-----█-----------█-█-█---█-------█---------█-------█---█---
--██████-█-█-█-█-██--█---█-█---█-█-█-█-███-███-███████-█---█-█-█████-█--████-█---███-███-█-█-█-█-███-
---------█-█-█-█-█---█-█---█-█-----█-----█---█-------█-█---█-------█-█---█-------------█-█-----█-█-█-
-█████████-███-███---█████████-█-████--███-█████-█-███████-█████--██-█████-█---█████-███-█-███--██-█-
-----█-█---█-----█-█-------█---█-█-----------█-█-█-█-█-█-█-█-------█---------█-----█---█-█---█---█---
██-███--██-█-█-█-███-█-█-██--█-█-█-█-███-█-█-█-█-█-█---█-----█████-███-█████-█-█-███-███-████-████---
-█-----█---█-█---------█---█-█-█-█-█-----█-█---█-----------------█-█---█-----------█-------█-------█-
-█-███-█-█-█-██--█-█-███-█-█-█-█-█-█████-█-█-███---█-█-█-██████--█████-█-███-█-████-███-██████-███-██
-----------█-█---█-█-█---█-█-█-█-█---█---█-------█-█-█-█-------------█-█-----█-----------------------
78 96