A--█---█-----█-█-----█-----------█-----------█-█---█-----------█-█-█-------------█-█---█---█---█-█-█-
-███-█-█-██--█-█-█--█--█---████--█-█-----█████-███-█-███-█-█-██--█-█-████-██-█--██-███-█-███-█---█---
---------█-█-█-█-------█-█-----█---------█-█-█---------█-█-█-------█---█---█-------█-█-█-█---█-----█-
-█████████-█-█-█--████-█-████████--██-██-█-█--██-█-███-█████-█-█-███-█-█-█████-█-█---█---██--█-███-█-
-█-------█-------█-█---█---█-█-█-█---█---------█-█---█-----█-█-█-------█---█---█-█---█---------█-----
-█-███-███-█-█-█-█-█-█-██-██-█-█-██-██-██-██-███-█-█-█-███-███-█-███████-█-█-██-██-█-█-████-██-█-█-██
-----█-----█---------█-------------█---█-█---█---█---█---█---------█-█-----------█-█-█---█---█-█-----
-█-█-███---████--█---███████---████--███-█-█-█-█-██--█-███████-█-█-█-█-███-█████-█-█-█-███-█-███-████
-█-█-----█-----█-█---------█-█-----------------█---█-█-------█-█-█-----█---------█---------█-----█---
-███-█-█-█-█-█-██-███-████--██-█████-█████-█-█--████-████████-████-█-█-█---███-████--█-█-█-█████-█-██
-------------------------█---------█-----█-█---------------------█-█-█---█-█---█-------█-█-----█-----
-█-███-█████-█-██-██-█--██-██--█-█-█-█--█---███--█-█-███-█-█-███████-███-█---███--██-█-█-█-█-███████-
-█---█-----█-█-----█-█-█---█---█-█---█-█-----█-█-█-█---█-█-------█---█-█-█---█-----█-█-----█-█-█-█-█-
-█-█-████-██---█-█████-███-█-█--█--█-█-█████-█-█-████--███-█-█████-█-█-██████--█--████-█---█-█---█-██
-----------█---█-----█-----█-█-------█---█-----█---█-----------------█-----------█-----█-█-█-█---█-█-
██-███████-█-███-█--██████-█-█-██-██-█--█--█---██-████-█--██-███-█--██-█-███-█-█-███-█-█-██████--█-█-
-----█---█-█---█-------█-----█-------█-█---█-█-█-█-█-█-█---█-█-█-█-------█---█-█---█-█-------█-------
██---█-█---███-█-█-█████-█████---██--█--█--███-█-█-█-██--██--█-███-█-█-█-███-█-███---██--█████-██████
-----------█-█-█-------█-----█-█---█-█-------█-----█-█-----------█-█---█---█-█-█---█---█-------------
-█-█-█---███-█-█████--██-█-█-███-███-█-█-███-███--██--██-█-█-█-█-███████-███-███-█████-█████-█-█--██-
-█-█-█-█-------------█-█-█-█-█-----█-█-█---█-----------█-█---█---------█---█---█---█-------█-------█-
-█-██--███---██-██████-██-██-█-█-█████-█-█-███-█-█-█-███-███-███-█-█████████████-███-█████████--████-
-----------█---------------█-█-█-----█-█-----█---█---█-----█---------------------------------█-█---█-
██-███---███---█-█-█-█-████-█-██-███-███-████-████-█████-█-███-██-█--███--█-█-██-█-█-█████████-█-████
---█-█---█---█-█-█---█-----█-------█---█-█-█-█-------█---█---█-----█---------█-█-█-█---█-----█-█-----
██-█-██--█-█████-██████████-██-█-█-███-███-█-███-█-█-███-█-█-███-███-█-██--███-█--█-████-███-███-█---
---█-----------█---█---█---█-█-█-----█-█-----█---█-█-█-█---█---------█-------█---█---------█-------█-
-███--██-█-█-█-████----█-███--███-██-█████-█-█-█-█-███-█-█████-█-█-█-█-███-█-███-█████-███████-███-█-
-------█-█-------------------------█---█-------█-█-----█---█---█---█-█---█-----█-----------------█-█-
██-█████-███-█-█-█-███-█-██--███-█-█-███---█-█-█-█-█-███-██-██-█-█-█-█-█-█-█-█-███--██████████-█-█-█-
-------█---█-█-█-█-█---█-█-----█-----------█-█-█-----█-------------█-█-█-█-------█---------------█---
██-█-█---█---█------██-█-███--████--█-████-█████████-███-██--█-█-█-█-███-███-█-█-█-███-█████-█-█-█-█-
---█-█-----█-█-█-█-█---█-█---█---------█-------█---█-█-----█---█-█-█-█-█-█---█-█-----█---█---█-█-█-█-
-█-█████-██-██████████---█---█-███-█---███-█████-█-█-█---█████-███████-█-█---█---█-█-█-███-█-█-█-███-
-█-------------------█-█---█-----█-█-------------█---█-█---------█-----█-█-█-█-█-█-█-█-█-------█-█---
-█████████-█████-█-█████-█-███-█████-███-████████-███-████-█-█████-███████-███████-█-███-█-█-█-████--
-------█---------█-----█-█---█-----█-█-█-----█---█-█-█---█-█---█---------█---█-----█---█-█---█-----█-
-█-███████-█-█-█-█████-----█-██████--█-█-███---███-█-█--██-█████-███-█---█-█---█-█-█-█-█-███-█-█-█-██
-█-█-█---█---█---█---█---█-█---------------█-----█-█---------------█---█-█-------█-█---█---█---█-█---
████-███---███████--██████-█-██████--███-█-██-████-█-█-███-█-█-███-██--███-███--██-█-█-█-█-███-█-██-█
---█---------█-█-----------█-█-█-█-----█-█---------------█-█-█---█-█-█-█-------------█---------█-----
██-███-█-█-█-█----████-█--████-█-█-█-█-█-█-███-█-████--█-█---█-█-███-█-███████-███-█-█---█-██-█--█-█-
-------█-█-------------█---█-█-----█---█---█---█-------█-█-█-█-█---█-█-------█-█-----█---█-----█---█-
██-███-█-███---███-█-█---██--█-█████-█████-█-█-█-█-███████-█-███-███-██████-██-███-█-███-█-█-█████-█-
-----█-█---█-------------------------------█-█-█-█-------█-█---█-------------█-----█-█-█-█-█-----█-█-
-███████-█-█-█-█████-█--████-█████████-███-██--█-██-█-████---█-███--█--█--█--███-█-█---█-██--█-███-█-
-█-------█---█-------█-----█-█-----█-----█---█-------------█-█-█-------█---█-------█-----█---█-█-----
-███-█-█-█----██-██--█-█-█-███-███--██-█████--██-███-█-█-███-███--██--██-████--█--██████---█-██--███-
-█---█-█-█-█-█-----█-█---█-----█-█---█---█-█-█-█-----█-█-----█-█---█---█-█---█-█-█-█-------█---█-█---
-█-█-███████-----█--██-█-█████-█--█-██-█-█-███--██-█████-█---█--██-█-█-█-█-███-███-█-███-█-█--██---█-
-█-█-------█-█-█-█-█---█-----█-----█---█-----█---█-----█-█---------█-█---------------█-█---█---█-█-█-
████-████--███-█-█-----███-█-█-█-█████--██-███-█-███-███-█-█-█████████-███-███--██-███-█-█████-█████-
-----█-█-----█-█-█-█-█---█---█-█-█-----█-█-----█---█-------------█-------█---█---█-----█-----█-----█-
███--█-█-█-█---█████--██-█████████-█████-█-█-███--██-███-█-█-█-█-█-█-█-███-███-██--█-█████--█████████
-------█-█-█-----█-----█---█-----------█---█-------█-█---█-█-█-█-█-█-█---█-█-█-------█---█-----------
████-█-████----█████-███-███-██████-███-██-█-█-██--█████-█-█---██-██--██--██-███---███-███-█████---██
-----█-------------█-█-------------------█-█-----█-█-----█-------█---█---------█-█-█-█-█-█-█-█---█---
██--██-█-███-█-█-██-█-██-█-█-█-███---███████████-█-█-███-█-█-█-█-█---███---███████---█-█-----██----██
-----█-█---█-█---█-█-----█-█-----█-█-------█-----------█-█---█-█-█-█-█---█-------█-█---█-------------
-█---█---█-█████-█-██--█-█-████-███-██-█---███-█-███-█-█████--██-███-█-███-█-█-█-█-█-█-█--██-██-████-
---█-█-█-█-█-█-----█---█-█---------█-█-█-█-█---█-----------█-█-----█-█-----█-█-------------█-----█---
-█-█-█-███-█-███-█-███-█-███████████-███████-█---██--███-█-█-█-█-███-█--██-█-███-█████-███-█-██-██---
-█---█-----█-----█-█---█-----█---█---█-------█-█-----█-█-------█---█-█---█-█---█-█---------█---------
-█████-█-█-█-█-█---█-███-█████--█-██-█-█-███-█-█-███-█-█████-███-█-█-█-█-███--██-█-█-█--████-█-██████
-█-----█-█-█---█-█-█---█-----------█-█-----█-█-----█-----------█-█-█-█-█---█---█---█-█-----█-█---█-█-
--████-█--██-█---█-█████-█-█-█████-█---███-█-█-█-███-█████-█-█-██--███-█-███-███-------████----█-█-█-
-█-----█---█-█-█---█-----█-█-----█-----█-------█-█-------█---█---█-----█-------█-█-█-█-------█-█-----
-█-█-█-█-█████-█-███-███-█-█-█-█████-█-███-█████-███-█████-███-█-█-█-█████████-███-██-██-█████-█-███-
-█-█-█-------█-█-----█---█-█-█-█-----█---█-█-█-█---------█---█-█---█---------█---█---█-----█---█---█-
██---█-███-█-███-█-███-█████-█-█-█-█-█-█████---█--████-█-█---█-█-█-█--█-█-███████--█--█████--███████-
-█---█---█-█---█-█---█-█-------█-█-█-------█---█---------█-█-█-----█-------█-----█---█-█---█-------█-
-█-███-█-█-----███-█-█-█████-█--██-███-████--█---█-███-███-███-█████-██--███-██--█████---█████-█-███-
-------█-█-█-----█---█-█-------█-----█-----------█---█-█-----█---------█---█---------------█---█-----
-█-███████████-█-███---█-███-█-█---█-███-██--█-█---█--██-███-█-█-███-█-███-█-███████-█-█-████--█-███-
-█-------------█-█---█-█---█-█-█-█-█-█---█---█-█-------------------█-█-█-------█-----█-----█---█---█-
-█---█---█--████-█████-█---███-█-█-█-█-█-███-█-█-█-██--███-█-█---█-█-███---██████--██████-████-██████
---█-█-█-█---█-------█-█-█-█---█-█-█-█-█-█---█-█-█-------█-█-█-█-█-█---------█-------------█-█-█-█---
-███-█-█-█-█---█-███████--██---███--██---█-███-███---█-------█-█-███-█--████-███-█--████████-███-███-
-----█---█---█-█-------█-█---█---█---█-█-█-█-----█-█---█-█-█-█---------█-█---------------█-----------
--██---█-█-█-█-█-███-███-█-█████-█--██-█████---█-█-█-█-█-█-█-███-█--███--█-███-██--█-█████-██----████
---█---█-█-█-█-█-█---█-█-█-----█-█---------█-█-█-█-█-█-█-█-----█-█-----------█-█---------------█-----
-█-██--█-█-█-█-███-█---█████-█-█-█████-█-███-█-█-█-█-█-██████--█-█-█-█-█-█-█-███---█-██████████████--
-█-█-------█-█---█-█-----█-█-█---█-█---█---█-█-█---█-█-█---█---█-----█-█-█-█-----█-█---------------█-
-███----██-█-█████-███-███--██-███-█-█-███-███-███-███-█-█████-█-█████-█-█-█-█-███-█-█████-█-█-████--
-------█-█-█-------█-------█-█---█---█---█---█-█-█---█-----█---------█-█-------█---█-----█-█-█---█-█-
██-███-█-█-███-█-█-███--██-█-█████████-███-███-█-█-█-█████████---███-█-███-███-███---█-███-███-█-█-█-
-----█-█-----█-█-█-----█---------█-█---█-█-█-█-----█-------█---█---█-█-█-----█-█---------█---█-█-----
-█-███-███-█-███-█-█-██---█-█--█-█-███-█-███-███-███-█-███--██-█-██-██-█--██████-█-█-█-█-███-████████
-█-█---█---------█-█---█-----█-█-█-------------------█---█---█-█---------------█---█---█-------------
██-█-███-██████--█-███--█████----█-█-█-█-██████--████--█-█-█-█-█--████-█--██-███-█-█-███-█-███████-█-
---█---█-█-----█-█-█-------------█-█---█-------█-------█-█-█-█-█-█--G--█-------█-----█---█-------█---
---█-███-█-█-███-███-███-█-███-██-██-███-██--███████-██████--███---█--████-████-█████--█-███-███████-
-█-█---█---█---█---█-----█-█-----█---█---█-----█---------█-----█---█-----█-----------█-----█-█-----█-
-█-███-█-█--███---█████--█-█-███-█-█-███-██----███-█████████-█-█████-█-█---█---███-███--██-███-███-█-
-█-█---█-█-----█-----█---█-█-█-█---█-█-█-█---█-█---------█---█-------█-█-█-█-█---█-----█---------█-█-
-█-█---██------█-█---█---██----█-█████-█-███-█--██-███-████--█-█---███-█-██████-██-█-█-█--██-███-████
-█---------█-█-█-█-█-█-█---█---█-█---------█-█-█---█-------█-█-█-█-█---█-------█-█---█-█---█---█-----
██--██---█-█-█-█-█████-█-█---███----████-███-█-█--█-██-█-███-█████-█████---███-█-█-█-███████-███---██
-----█---█---█-█-----█-----█---█-█-█-------█---█-█-----█---█---█-█-------█-------█-█---------█-------
-█-█-██--█-█-█-███-█---█-█-█-█-███████-█████-█-█-█-███-█-█-█-█-█-█---██---████-███████---█-█-█---█-█-
-█-█---█---█-█-------█-█-█-█-█-------█---------█-█---█---------------█-------█-------█-█---█-█-█-█-█-
90 68