A----█---------------█---█-----------█---█-█---█-----█-█---█-----█-█-█-█-█---█---------█-█---------█-
-█████-█-█--█-██-███-█-██--█-███-█████---█-█--██-█████-██--█-█████-█-█---█-███-█-█-█---█-█-█-███-███-
---------█-----█-------█-█-█-█-█-█-----█-█---------------█-------█-----█-█---------------█-------█---
██-█-█████-██--█-███-██----█-█-███-█---█-█--██-███-█-███---█-██-██-███-█-█-███-█-█-█-██-██-█-█-███-█-
---█-------------█-█---------------█-█-----█-█-█-█-█-----------█-----█---------█---█---------█-█-█-█-
-█-███-█-█-█-█-███-███-██--█-███████-█-███---███-█--██-█-█-█-███--█--█-███-█████-█-██-█-█-██-█-----██
-----█-█---█-----█-------█-█-------█-----------------█-█---█-------█---█-------------█-█-█-█---------
██-█-█-█-███-███-█-█-█-█-█-█████████-█-████--█-█-█-█████-█-█████████---█-█-█--████-█-█-█-█-█████--██-
---█-█-█---█---█-█-█-█-█-----------█-█-----█---------█-------------█-█-----█-----█---------------█---
-███-█-█-█-█-███-█---█-█-█-█---█-█-█-█████████---█████-███-███---█-█-███-███----██████-█████-█-██-███
-----█-█---█---█-█-█-█-█-----█-----█---------█-----█---█-█-----█-█-█-----------------█-----█-█-------
-█-█████-███-█-███-███-█-█-███████-█---██-██-███████-█-█-██████--█-█--██████-█-███████-█████-█-█-███-
-----█---█-------█-█-█-█-█-------█-█-█-█---█-█-----█-█-█-█-----█-█-█-█---█---█-█-█---█-------------█-
-█-███-██--██-████-█-███---█-█-█-███-█-█--███--█-█-█-██--█-█-█████████-██-██-█-█-█-█-█-█████-█-█-█---
-█---█-█-------█-█-----█---█-█-----█-█-----█---█-----------█-----█-█-------------█-----------█-----█-
-█-███-███---██--███-█-█-█████-█████████-█-█-█████-███-█-█████████-█-██-█-██-█████-█-███---█-█-█-█-█-
-----█-█-----█-█-----█-█-█---------█-----------------█-█-----------------------------█---█---█-█-█---
-███-█-█████-----█-███-█---█---█-███-█-█-███-█-███--█-███----███--██-██-██-█--██-█████-███-█-█-█-█-█-
-----█-█-------------█-█---█---█-------█-█---█---█-----█-█---█---------█---█-----------------█-█-█-█-
-████-██-█-███-███--██-█--█-██-█-████-███---██████-█-███--██-███-█████-█-█-█-███-█-█-█-███-███---███-
-----█---█---█-█-------█-█-------------█-█-----█---█---█-----------█-█-█-█-█---█-----█-█-█---█-█-----
-██-█████--█-███-██████---█████----███---█-█-█---█---███--██████████-█-█-███-████--█████-█-███-█████-
---█-------------------------█-------█---█-█-█-█-█-----------█-----█-------█---█---█---------█---█-█-
-█████-█--██-█-███---█████-████--███-█████████-███--████-██----███-██--█████-███████-█-█-█-█-█-███-█-
-----█-------█---█-█---------█-█-█-█-█---█-█-█---█---█---█-------------█-█-█-------------█---█-█---█-
██-█-█-███---█████-█-█-█-█████-███-█-█-█-----███-███-███-█--████-█-█████-█-██-█-██-█-█-███-██--█--██-
-----█-█---█-----█-█-█-█-------█-█-█---------█-------█-█-------█-█-----------------------█-----█---█-
-███-█-█-█---█-█---█-█-█-█-█████-█-███--██-███---█████-█-█████-███--████-█---█-█-███████-█-█████--██-
-------█-----█-█-█-----█---------------------█-█---------█-------------█-█-█-----------█-------█-█---
-█-███-██--███-█-█-███--██-█-███-█████-█████---█-█-█--██-█-██████████-██████-█-█-█-████--████-██-███-
-█-------█---█-----------------█---█-█-----█-█-█-█-█-█---------------█-█-----█-█---------█---█-------
-█████-███--██-█---███████-█-█-----█-███████-█-█-█-█-█-█-█---███-█████---█---███████████-█-█---█-█-█-
-█-----█---█-----█---█-█-█-█---█-----------█-------█-█-█---█---█-----█-█-█-█-█---------█---------█-█-
-█---█-██--█-█-█-█-███---███-█████-███-█----██████-███-███-███-█-███-█-██-██-█-█-----███████-█-███-██
-----█---█-█---█---------█-----█---█---█-█-----------█-█-█---█-█-█-------█-----█-█-█---------█-------
-███--██-███-█████--██-█-█-█-█-█-███████-█-█---█-█-█████-████-███--███-███████-█████---█-███-█-█-████
-█-█-█---------█---█-----█-█-█-█-------█-█-█---█-------█-█-█-----█---█-----█-------█-█-█-█---█-█---█-
█----█-█-█-█-█-█-███-█-█████-██████-█--██--█-███-████-██-█-█-███-█-██--██--██--█-█---███-██-██-█-███-
-----█-█-█-█-----█---█-----█---------█-----█---█---------------------█---█-█-█-█---█---█-█-----█---█-
-█-█-█---█-█-█-███-███-█████---█████-█████-███████-█-█-███-███--██████-█-███-█-█-███-█████-███-█-██--
-█---█-█-█-█-█-█-------------█-█-------█-█-█-----█-█-█---------█-----█-█-----█-█---█-----█-█---█-----
---███-█████---█-█████-█████-█-█-█████-█---███-██-██-█████-█-█-█-██-██-███-███-█-██--█-█-█████-█-███-
-----█-----█-█-█-█-█-------█-█---█-------█---------------█---█---█---█-------------█-█---█-----█---█-
-███-█████-███-█-█---█--██---█████-███-█-█--██-███-███-█--██████-█-██-██--██████--██-███-██-████----█
---------------█-----█-----█---█---█---█-------------█-█-------------█---------█-------█-----█---█---
-█-██---██-█-█-█--█--█---█---███-█-██████--██-██-█-█-█████-█-███-█-██-██-█-█--██--█████-████-█--███-█
-█-█-----█-█-█-----█-█-----█---█-█-█---------█-----█-----█-----█-█-█-█-█-█---█-█---█---------█-------
-█████-█-██████--██-██-█-█-███-█---███-███-█---█--██---█-█----██████---█-█-█-█-█-█████--█---██-█-██--
---█-----█-----------█-█-█-----------█-█-█-█---█---█---█-█-█---█---------█-----------█-------█-█-█---
-█████-███-███-███-█-█--██-█-███-█████-█-█-█-█-████--█---█-██--█-█-█-█-█-███-█-█-██-██-█████-███-██--
---█---█-----█-----█-█-█---█---█-------█---█-----█---█-------█-----█-█---█-█-█-█---------█-█-█-----█-
██-█-█████-███-█████████-█-█-█-█-█-███████-█--██---██--█-██-████-█-████-██-█-█████-█-███---█-█-█████-
---█---█---█-----------█-█-----█-█-█-------------█-█-------------█---------------█-█---------█-----█-
██---█████-██--█-█-----█-█-███-█████████-███-█████--██-█-█-███-█--████-█████-███-█-█-█-█-██-███-██-█-
-------█-------█-█-█---█-█---█-----█-----------------█-█-█---█-█-----█-█---█---█-█-█-█-█-------█---█-
-███-█-███-█-█-█████--█--█-█---███-█-█-█-█-██-██--██-█---█-█-███---███████-███████████-█████-█-█-████
---█-█---█-█-█---█-----█-█---█-█---█-█-------█-█---█-█-█---------█-█---------------█-----█-------█-█-
---█-█-█-█-███-█-███-█-█-█---█-█-█---█-█-█-█-█-█-█████-█-█-██--█-█-█-█-███████-█████-█-███████-██--█-
---█---█---█---█-█---█---█---█-█-█-█-█-█-█-█---█---------█-----█-█---█---------------█-------█---█---
-█-█-███-████--███-█-████--█████-█-█--██-█-███-█--█-██████-█-████--█████-█████████---█-█████---███-██
-█-----█-█-------█-█-█---------█-█-------█---█-█---------█---█---█-█---█-------------█-----█-█-------
-█-█-██-██████-█-█-█-█--███--███-██--█-█-█-█-█-█-█-█-█-█-█-█-█-███-█-█-███-███-███--██-███---█████-█-
-█-█-█-█-█-█---█---█-█-█-------█---█---█---------█-█-█-----█-------█---█-█-█-█---█-------█-█-█-------
---███-█-█-███-█--████-███---█-█-█-█-███-█-█-███-█-██--█-█-█-███-███-██--███-█-█-███---█████-███-███-
-------------------------█-█-----█-█---█-----█---█---█-█-------█---------------█-█---------█-------█-
██-█-█-█-█-███-█--██████████-█--██-█████████-███--████----████-█--████--███-██-█████-█-█-█-█-███-█-█-
---█-█-█-█-█---█-------------█-█-----------█-█-----------------█-█---------█-----█---█-█---------█-█-
██-█--██████-█-█-████-███████--█-█-█---███-█████-██-████-█-█-███-█-█-██-█--█-█████-███-█--████-████--
---------█-----█---------█---█---█-█---█-█---█-█-----█-----█---█---█---█---------█-----█-----█-----█-
-█-█████-███-█-█-█-█-███-███-█-███-█-█-█-█-█-█-█--██--██-█████-███-███-█-█-███-█-█████--██-█-███-█-██
-----█-█---█-█-------------█---█---█---█-█-█-█---█-----█---█-█---█-----█-------█-█-█-----█-█---█-----
██-█-█-███-███-█-█-█-█---███-███-█-███-█-██--█-█--██-█-█--██-█-██--█-█---█-█████-█-█-█-██--█-████████
---█-----█-----█-█---------------█-█---------█-█-----█-----------█-█-█-----------█-█-█-█-█-█---------
-█-███-████████--███-█-█-█-███---██-██-█████-█-█-█-██-██------████-███-█---████-██-██-██-█---██-████-
-█---█-█-----------█-█-█-█-█-█-█---█-----█---█-█-------█-█-█---█---█---█-------------------█-----█---
████-████████--█-█████-█--██-███████-█-█████-█-███-█-█---█-███████-███-█-███-█████-█-████--██-██-█--█
-----------█---█-------------------█-█-------█-█---█-█-█---------█-----█---█-----█-█---------█-█-----
-█-█-█-███-█-█-█--█-███--█████-█-███-█-█-███-█-█-█-█-█---------██████--█████-█-██--████---██-█-██████
-█-█---█-----█-█-----------█-█-█---█-█-█-█-█-█---------█-█-█-█-------------█-█-█-█---█---------█---█-
-█---███-█████-█-███-███-█-█-███-███-█---█-█-██-██-███-██--█████-███-███-█-███-█-█-█-█████-█-█████---
-█-█-----█-----█---█-------------█-█-█-█-----█-------█-█---█-█---█-----█-█---█-----------█-█---------
██-███-█--██-███-█-█████████-███-█-█████-███-███-█-███---█-█-███-██--█-█-███-█--██-█-█-█-█-----███-██
-----█-█-█-----█-----█-------█---------█-█-------█---█-█-█-----█---█-█-█-█---█---█---█-█-█-------█---
██-████--█-█-█████--█████--█-█-█-███-█████-█-----█-█-████-█--█-█-███-█-██--█-███-█-█---███████-██-██-
-----█---█-█-█---------█---█-█---█-------█---█-█---█-----█---█-█---█-█-█---█---█-----█-------█---█-█-
---███-███-██-████-██--█-███-█-█-█-███████-█-██--█-████████--█---███-█---█-█-█-█-█-█-█-█-████████--█-
-█-----█---█---------█-█---------------█---█---█-----------█---█-█-█-█-█---█---█-█---█-█---------█-█-
-█-███-█-█-█-████--█-████-██████-█-█-█████-█████-█-█-███-███-█-█-█-██-█--█-███--██-█-█---█--██--██-█-
-█-█---█-█---█-----█-------█-█---█-------█-----█-█-█---█---█---█---█-----█---█-█-------█---------█---
█--█-█-███-█████-█-███-█-███---███-█-██-█-██-███-█████-███-█-█-█-█-█-█-█--████████-█-█---█-██-██-███-
---█-█-█---█-----█-----█---------█-█-----█---█-------------------█-█-------------█-█-█---█---█-█-█-█-
██---█-█-█-----███-█--█----██--███████-██████-██-█---█--████-█-███-██--█-█-█████████-█-█-█-█-█-██--██
---█-█-█-----█---█---------█-█---█-------------█-█-█-----█---█---------█-----------█---█-█-█---------
-█-███---█-█-█-███--█--█-█-█-███-█████-█-█████-████--█-█-██-██---█-███-███-█-█-███-███-█-███████-█-██
-█-█---█-█-█-█-█-----█-█-█-------------█---█-█-█---█---█---█---█-█---------█-----█---█-----------█---
██-███-█████-█████--█----█-██-███----█-█-█-█-███-█████-█-███-█-███-█-█-███-█-█-█-████--███-█--██-█-█-
---█-█---█-█-----------█-█-------█-█-█---█---█---█-█---█-█---█---█-█-█---█---█-------------█-█---█G--
-█-█-███---█-█-███-█---█-███--██-█████████-██--█-█---███-█-█-███-█-█-█-█-█████-███-██--█████-█████-█-
-█-----█---█-█-█---█-█-█-------█---█-------------------█---█-----█-█---█-----█---█---█---█---█-------
██-███-█---██-████-█---█-███-█-█-█-█-█-███-█-█-█-█-█-█-███████-███-██--███-█-█-█-█████--██-██---██-█-
---█-----█---------█-█---█---█-█-█---█-█---█-█-█---█---█-------█-----------█-█-█-----█-----------█-█-
96 98