A█-----------█-█-----------█-█-------█-█---█---█-----█---█-------█-----█---█-█-----█---█-█---█-------
---█-█-█████-█-█-███████-█-█-█-██-████-███-█-███--█--█-█████-█-██----█-█-███-█---█---██--█-█-█-█-██-█
-----------------█-----█-----------█-----█-█-------█-█-------█-----█-█-█-------█---------█-----█-----
--██████-█---█-█---███████████████-█-█████---█---█-█-█--███--█-█-██--█-█---██-██-█████████-█-█-██████
-------█-█-█---█-----------█---█---█---------█---█---█---█-█-------------█---------█-------█---------
-████████-██████-███-█-█-█-█-███--██-███-███-█-███-█-█-██--███-█-███████-█-█-█████---██████--███████-
---------------█-█-█---█-------█-----█-█-█-------------------█-█-------█---█-----------------------█-
███--██████████--█-█-█-███-███-█-███-█---███-███████-█-██-███████--███-█-███-███-███-███████████████-
---------------█-----█-----█-------█---█-█-█-------█-------------█-------█---------█-----------------
██-█---███-█████-██-████--█--█████-███-█---███████-█-█-█---█-█████-█████████-███-█-█-█-█-███████-███-
-█-█-------█---█-█---█-█---█---█-----█-----█-█---------█-█---------█-----█---------█-------█---█-█-█-
-███-█-█-█-█-███-█---█---██--█████-█████--██-█-█████--████-█-█-███---███████████-█---█████-█-█-█-█-█-
-------█-█---█-█-█-----█---█-█---------█-----------█-█---█-------------█-----█-█-█-█-----█---█-------
-███-██-██-█-█-███-███████----████-█-█-████-██-█-█--██-███---█-█████-█-██--█-█-██--█-███-----██-██-██
-█-----█---█-----------█-█-█-█-█-█-█-█-█-█-█---█-------------█---------█---█-----█-█---█---█-█---█-█-
█----█████-█----████-██--███---█-█-█-█-█-█-███-█-█-█---██-██-███-███-█-█---█-█-█-█████---██-██-█████-
---█-----█-█-█-----█-----█-█-█-█-█-█-█-------█-█-█-█-█-------█-----█-█---------█-----█-█-----█---█-█-
-█-█████-█-█-█-███-██--███-█-█----██-█-█-███████-██--█-█-█████-█-███-█████-█-██████-█-██--██-█-█-█-█-
-█---█---█-█-----█---█---█-█---------█-█-█-█---█-█---█-█-------█-█-█---█---█-█---------█-█-----------
-█-███████-█-█-████--█-███-█-███-█-███-█-█-█-███-█-█-██-██--██████-█-█-█-█████-█-███████-█-█-█-█-█-██
-█---█-------█-----█-------------█-------█-█---█-----█---------------------█-------█-█-█---█-█---█---
---█-█-███-█-█-███████████-███-███-███-█-█-█-██--████-████--██-████--█-█-███-███████-█-███-███-██-██-
-█-█-█-----█-█---█---█-------█-------█-█-------█-█-█-----█-------------█-----█-█-----█-------------█-
-█████-█--██-█-███--████-████████---████--██-███-█-███-███-███-█---███-█████-█-█-█--██-█-███-█-█-████
-█---█-█-█---------█-----█-------█-█-█-█-------█-█-█-█-------█---█---█---█-----█-----█-----█---█-█---
-█-███-█---███-█-█-███-███----█-███--█-█-███-███-█-█-███-█-█-█-█-████--█████-█-███-██--████-██████-██
---█-█-█-█---█---█-----------█-█-█-█-█-------------------█---------█-█-█-----------------------█-----
-█-█-█-█-█-█████-█████-█-█-███-█-█-█-███-███-█-█-█-█----████-█-█--██-█---█-█-█-█-█████-█-█-█-█-█-████
-█---█-----█-------------█-----------█-█---█---█-█-█-█---------█---------█-█---█-█---█-█-█-█-█-------
-███-██--█-███---███-███-███-████-██---███-█-█-██--█-█-███--█-████-█-█-███-█-██-----██-█-█-████--█-██
-------------█-█---█---█-█-█-------█---█---█-█---█-----█---------█-█-█---█-█---█---------█-█-█---█---
-█-███-█-█████-████--█--██-█-█████----████-███-███-█-█-███-█-█---█████-█-███-███-█-███-█-███---█-████
-█---█-█-█---------█-█-█---█-------------█-█-----█---█---█-█-█-------█-█---█-----█-----█-█---█-------
██-█-███-██--██--███-█████-█-███-██--█-█-███-█--██-█-█-███-█-█████-██--█-█-█-█-███████---█-██--██████
---█-█-█-█---█-█-----█---█-----█---█-█-█-█-█-█-----█-█-----█---█-█---█---█-█-█-█-█-█-█-█-----█-------
-█-█-█-█████-█-███-█-█-█-█-██████--█--████-█-████-██-█---█---█-█-███-█-█-██--█---█-█-█-███--█--█-████
-█-----█-----------█-----------█-█-█-------█-------█---█-█-█-█-------█-█---█-█-------█---█-----------
██-█-███-█████-█-███-█-█-█-█---█-█-███-██--█-███-█-█-███-███████-█-█-█--██-█-█-█████---█████--███-███
---█---█---█---█-----█-█-█-█-█-----------█-█---█-█-█---█---█-----█---█---█-█-█-----█-----------------
---█--██-█-█-█-█-██--█-█-█-███-███-███-█████--████-█-███-███-███-██--███-███-███-█-██-██-███-███-█---
-█-█---█-█-█-----------█-█---█---█-█-----█-█---█-█-█-----------█-█-█---█-█-█-----█---█---█-----█---█-
-█--██-███████-██--█-██-████-█--██----██-█-█-█-█-███-█---█-█████-█-█-█-██--█-█████-█████-█-███-██--██
-█---█---------█---█---------█-█-█-█---█-█---█---------------------------------█-█-------█---█---█---
-██-██-█-███-█████-█-███---█-██--█-███████---███-█████-█-██--█████-███-█--███-██-███████-█---█-█-█-█-
-----█-█---█-█-------█-----█-----█---------------------█-------------█-------------█---█-█-█---█-█-█-
---██--█---█-███--██-█-█████████-█-█-█-███-█--██-█-███████-█----██████-█-█-███████-█-█-█-█-█-█-███-█-
-█-█-█---█---█-█---█-----------█-█---█---█-█---█-█-----█---█-----------█-█-█---█---------█-█-█-█---█-
████---█-███-█-█-█-█-███-█-█-█--█-█-██-█--████----██████--██-█-----█-█--████-█████-███-█-█-███-█-████
-----------█---█---█---█---█-█-----█---█-----█-█-----------█-█---█-█-█-----------█-█---█-█-█---█-█---
██-█-█--██--██-█-█-█-███-█-███-█-█████-█-██████--█-███--██-██-█---█--█████-█-█---█-█-----█-███-█-█-█-
---█---█---------█-█-█---█---█-█-█-----█-----█-█-█---█---█---█-----█-----█-█-----█-----█-----█-----█-
█--███---█-█-█████-███-█-█-█-█-█-████--█-███-█-███-█-███████-█-█-█-█-█-███-█-███--██----██-██--███-█-
-----█---█-█---█-------█-█-█-----█-----█---█-----█-█-----█---█-----█-█---█---------█-█-█-----█---█-█-
-███--████-█-█---█-█████-█-█████-██-██-█-----███-█-█████-█-███-█-████-█-█-████-███-█████-███-█-███-██
-█-█-█---------█-█-█-█---█-----█-------█-█-█---█-------█-█-----█-------█-----█---█---------█-█-█-█---
---███--██-█-███-███-███-███-█████-█-█-█-████-██-█-█-██--█████-███---███-███-███-█---█-█-█-███---███-
---█-----█-█-█---------█---█---█---█---------█---█-█---█---█---█---█-------------█-█---█---█-----█---
---███---█--████-█--█-██-███---███--██-███-█-██-█████-██---███-█--██████-█████-█████-█████-███--██-█-
-█-----█-█-█---█---█-------█-█-█---------█-█-----------█-█-█---█-------------█-----█-----█-█-----█---
-███-███-█-███-███--██-█-█---█-█████-█-███-█-█-███-█-█████-███-█████-███-███-███-███████████-███-█-█-
-█-------█-█-█-----█-----█---█-█-----█---█-█-█-█---█---█-----█---█-----█-------█---█---█-----█---█-█-
██-█-█-█-██----█-█-█-█-███-█-█-███-█-█-█████████-█---█-██--███-█-███-█--██-███---█████-█-█████--████-
---█-█-█-█-----█-█-█-█---█-█-█-----█-█-------█-█-█-█-█-----█---█-█---█-----------------------█-------
-█-----█-█--██-███-█-█-███---███-█---███-█-█-█-█████-█-████████--█-█-█-█-█-█--██-█-█-███--████-██--█-
-█-█-█-█-----█---█-█---------█-█---█-█---█-█-------█-█-------------█---█---█-----█-█---█-█-█-------█-
-███-███-█-█-█-█-█---█-█-█-███-█-███-█-█-███-█-█████-██-██████-███████-███████---█-█-██-██-█--██-█--█
-█-----█-█-█-█---█-█-----█-█-------█-█-█---█-█-----█-█-----█-█---█---█---█---█---█-█-------█-█-█-----
█--█████-█████-█-█--███-██-███-█-█--████-███-█-█-█████-█-███-█-█-█-█---█████-█-█-███-█--███--█-█--██-
-----█---------█-█---█-----█---█-█-█-----█---█-█-█-█-----█---█-----█---█-------█---█-█-█-█-█---█-█---
█--███-█-██-████-█-█-███-████████--█████-█████-█-█-█-█-████--█-█████-█-█-█-███-█████-██--█-█-█-█-█-██
-----█-█-------█---█---█---█---------█---█---------█---█-█---------█-------█-------█---------------█-
-█--█--█-█-███-███---███-█-███-█-█-█-█---███-█-█--██-███-███-█--██-█-█-█████-█-█████████-█-█████-█-█-
-█---█-█-█-------█-█-█-----█---█-----█-█-█-█-█-█-------------█-█-█-█-█-█---█-----------█-█--G█---█---
████-█-█-██---██-███-███--████-███-███-███---█-█-████-███-██-███-█-█-███-█-█████-█████-█████-█████-█-
-----█-█-█---█---█---█-█---█---------█-------█-█---█-----█-----------█---------█---------█-█-----█---
-█-███---███---█-██-██-█-███-█-███-█--████-█-███-███-███-███-█-█---█-█---███-█-██--███-█-█-███---█-██
-█-█-----█---█-█-----█-------█---█-█-█-█---█-----------█-----█-█---█---█-█-█-█---------█-------█-----
-███-█-██--█---███-██--█--████-███--█--█-█--██-███-█-███---██-█--█-███████-███---████████████-████-██
-----█---█-█-█---█---█-█-█-------█---------█---█---█-------------█-------------█---█-------█---█-----
-█-███-█████-███-█---█--██-█---█████-███-███-███-█-█-█-███-███-█-███-█-█-███--█--█-█-█-██--█-█--██-█-
---█-----█-----█-█-----█-█---█-----█---█---█---█---█-█---█---█-----█-█-█---█-----█-----█-█-------█-█-
-███-██--███-█-█-███████-██--█-█-██-██-█-█-█-█████-██-█--███-██----█--█-█--█-███-█-█-███-█-█████-█-██
-█-----█-----█-█---█---------█-█-█-------█-█---█-█---█-█---█---█-█-█-█-█-█-█-█-█-█-█-█-----█-█-------
████-███████-█-█-█-███-████--█-█--█--███--████-█-█---█-█-█-█-███████-█-█--████-██-██████-██--█-██----
-------------█-█-█-█---------█-█-█-----█---------█-█-█---█---------█-----------------------------█-█-
-█----████-████----█-█-█████---█-█-█---███-█-█-█-█-███-█-█-█-███-███-█-██-██████-███-█████████-█-█-██
-█-█-------------█-█-█-█-----█-█-█-█-----█---█-█-█-█-----█-----█-----█---█---█-█-█---█---█-----█-█---
██-█-███-███████-███-███--██-█-█-█-█-█-█--████-███---█-███-███-█--████-█-█--██-█-███-███-█--███-██-██
---█-█-------█-------------█-█---█-█-█-----█---█---█---█---█---------█-----█---█-█-------------█-----
-█-███-█-█████-█-█-███-█---███-█-█-███-█████-█-█-█-███-█-█████-██-████---███-█████-███-█---█-███-█-█-
-█---█-█-█-----█-█-------█-█---█-█-█---------█-█-█-█---█-----█---------█-----█-█-----█-█-█-█-----█-█-
--██-████--█-█-█-█--█-██---█-█████-█-███-███-█████-██--███-██--█-█-█-█-██--█-█-█-██████████--█-█-█-█-
---█-█-█---█-█-█-█-█-█---█-█-█-------█-----█-----█-█---█---█-█-█-█-█---█-----------------█---█-█-█-█-
██-█-█-█-███-█-█--██-████--█-███-█-█-█████-██████-████-█████-█-█████-█--██-█-█-█-██--█-█████-█-██████
-------█-█---█-----------█-█-█-█---█-----█-----█-------------█-----█-█---█-█---█---█---█-----█-------
█--███-█-███-█-█-█-█-███-█-███-█████-█-███-█-█---█-███████-█-█--██-█---███-█-█-█-█--██-███-█-█--██-██
---------█-------█-█---█-█---█---█-█-----------█-█-█---------█---█---█-█---█---█-█-█-█---█-█-█-█-█---
███-██--██-█-███-███████-██--███-█-███-█-█-█████-██-██-█-█-█-█-███████---█-█---█-█---███--██-█-█-███-
-------█---█-█-----█-------█-█---------█-█---------█-----█---█-----█---█---█---█-█-------█---█-----█-
█████--███-█-█-██████--█-█████-█-███-█-█-█-██--███-███████-███-█-█-█-█-█-██--█-----████--█---███---█-
---------------------█-█-█-----█-█-----█-█-------█---█---------█-█-█-█-█-█---█-█-█-------█-█---█-█---
72 92