A█-█---█---█---█---------█---█-------█-█---------█-█-█-█---█-----█---█-█-█---█-----█-█-█---█---------
-█-█-█-█-███-███-█-█-█-█-█-███-█-█-███-███--███-██-█-█-█--██-███-█-███-█-███-███-█---█-███-█-█████-██
-------█-------█---█---█-█---█-█-█---------█-█-█-█---------------------------------█---█-------------
-███████--██-███-██-██████-███-█-███-██-██-█---█-█-████--█--██-█-█-███-█████-███-█-███-█-█████-████-█
-------------█---█---█---█-----█-█-█-█---█-█-█---------█-█-█---█-----█---█-█-█-----------------------
-█-█-█████--██-███---█-█---███████-█-███-█-█-█-█-███-███-█-███---███-█-███-█-█-----███-███-███-███-█-
-----------█---█-█-█-----█-----------█---------█---█---█-█-█---------█---█-----█---------█---█---█---
-█████--████-███-█--██--██-█████-██-██-███-█-███-███-█-███-███-█-█-███████-█████-█-█-█-███--█-██-████
---------------█---█-------------█-█---█-----█-----█-------█---█-------█-------█-------█-█-█---█---█-
-█████-█-███████-█-███---█--██-███-███-█-██████-██-███████-█-███-█-█--███---██████████-█-█---█-██-██-
-█---------------------█-----█-------------█-█---█-----█-█---█---█---█-----█-█-------█-----------█---
---███-███-█---███████████-█████████-█████---█-███-█████-███████-█-███-█-███-█-█-█-█-█-█-██████-██-██
-█---█-█---------------█-█---------------------------█---------█-------------------█-█---█-----------
██-███-█-█-█-█-███-██-██-█---█-█-███-█-███-███-█████---██████-██-█████████████-██--███-█-█---███████-
-█-█---█---█-----█-------█-█-█-█---█-█-█-█-█-█-█-----------█-█-█-------------█-----█-█-------------█-
---█-█-█-█-█-█-███-███-███-████--█-█-█----██-███-███-█-█████-█-█-█-█--██-█-███████-█-█-█-███-██████-█
-----█-----------█-█-█-█-----█-----█---------█---------█-----█-----█-------------█-----█---█---█-----
-██--█--██---█-█-███-███-███-█-█-█-███-███--██-█-█-███-█-█████-█-██--██████--███-███-█-█-█-██-██-███-
---------█-█-█-█-█-█-█---------█-█-------█-----█---█---█-----█---█-----█---█---█---█-█-█-█-----------
-█-----███-█-█-██--█-█-███--██-█-█-███-█-███-█-███████-█-██----█-█-█-███---█████-█-█-█-█-█-█-███-█-██
-█-█-----█-█-█---------█-█-█-█---█-----█-----█-----█-------█---█-█-█-----------█-█-█-█-█---█---█-█---
-█-█-███-█-█-█-█-██-████-█-█-███-█-██----███-█████████-----█████-█-███-█-█-█-█-██-██-█████-█-█-██-██-
-█-█-----█-------------------------█-█-█-----█---█---█-█-█-------█-█-------█-----█-█---█---█-█---█---
-███-█-█-███-█-█-█--██-███--██-███-█-███--████-█████---█--██-█-█-█-█-█-███-███████-██-█-██-█████-█-██
-█-----█-----█-█-█---█-----------█-----█-----------------------█-----█---█---█-█---------█-█---█-----
-█----████---█-███-█---█-████---██████-█-███-█-█-███-███-██████--███-█████████-█-█-█████████-██--████
-█-█-█-█-█-█-█---█-█-█---█-█-█---█-█-█-█-----█-█---█-█-------------█-------█-█-------█---█---█---█-█-
-█-███---█-█-█--█--█-█-█---█-█-█-█----████---█-█-█--██-█-█-███-█████-█-█-█-█-█-███████-███-█-█-█-█-█-
-█-------█-█-█---█-█---█-------█-----------█-█-█-█---█-█-------█-█---█-------█-----█-█-----█---------
█--█-███-█-█-█-██----██--█-█-█-███-█-███-█████-███-█-█-█████-███-█-█-█-███-█-█-██--█-█-█████-██-████-
-------------█---█-------█-█---█-█-█---------█---█---█-------------█-█-█---█-----█---█---█---------█-
█--███---█-███---█-███-███---███-███-█-█-█-██--███--██-█-█-█████-██████-█-█--█-███-█-█--████-█-█-█--█
---█---█-█-█---█-█---█-----█-----█-█-█-------█-█-----█-█-█-----█-----█---█---█---------------█---█---
---█-█-█-█-█-█-███---█████--████-█-█-███-█---███████-█--██--██-████-██-█-█-███-███-█--████-███-██████
-█---█-█---█-----█---█-------------█-█---█-█---------█---█-------------█-█-█-----█-█-----█-█-----█---
█--█-███-█-███████-█-███-█--████-██--█-█-█-████-██-███---█-█-█-███-█-███-██-███--████-████--██████-██
---█-█-----█---█-█-----█-----█---------█-----█---█-----█-----█---█---█-----█-----█-█---█-------------
-----██--███-███-█-█-█--████████-███-███--██---█-█-█---█-█████-████-███--███-███-█-█-██████-██-███-██
-█-█-----------█---█---------█-----█-█---------█-█---█-----█-------█---------------------█-█-█---█-█-
-█-█-█-█-----███-█-███-█-███-█-███---█-███-█-█-███-█-█████████-█-█-█-█-███-█-█-█-███---███-█-█--████-
---█---█-█-█---█-█-█---█---█-█---█---█---█-█-█-----------█-█---█-█---█---█-█---------█-------█-█-█---
-█-█-█-███---█-███-███-███-█-█-█-█-█████████████-██-██-██--███-████--█-█████-█-███-█-█-██--████--███-
-█-█-----█-█---█-----█---█-----█---------------█---------------█-█-█---█-█-█---█---█-█-----------█-█-
████-█-███-███-█-█---█-█-█-█-█-██-██-----███-██-██████-█-██-██-█-█-█-----█-█-█-█-███-███-████-████-█-
---------█-█---█-█---█-█-█-█-█-----█-█-----█---------█---█-█-------█-█---█---█---█---------█---------
███--███-███-███-█-█-█---█-███-███████-███████-█-█-███-█-█-███-████-██████-█-█-██--███-█-███--██---██
-█-----█-█-█-█-█-█---█-█-█-----------█-█-------█-█---█-█-█-█-█---█---------█---█-----█-█---------█---
-███---███-███-█-█---██-██-█--██-███-█--█---██-███---█---█-█-███-█-█-█---█-█-█-██-█--█-█-█████-███---
-----------█-------█-█-█---█-------------█---█---█---█-█---█-█-----█---█-█-█-------█-█-----█-------█-
-█-█-█-█-█████-█████-█-███-█-█-███-█-███-██-██-███-█-█-█-███-███-█--██-█-████-████-██-██--██-█--██-█-
---█-█-█---█-----------█---█-█-----█---█---█-█---█-█-█-█---█-█---█-----------------█-█---█---█---█-█-
-███-█-█-█-█-█---█-█--████-█-█-███-██--███-█-█-███-███-█---█-█-██--█-███-███-███-███-█-█---█-█-███-██
---█-█-----█-█---█-█---█-█-█-----█---█-█-█-█-----█---█-█-█---█-█-█-█---█-------█-------█-█-█-----█---
-██-██-███-█-██--███-█-█-█████-█████-█-█-███-██--█████-█-█-█-███-███-█-█-█-█-██--████---██████---███-
---█-█-----█---█-█---█-------█---█---█-----█-█-█-█-█---█-█-█---------█-█---█-█---█-█---█-------█---█-
-█-█-█-█--██--█-███--███-█████-██-████-█-██-██-█-█-█-█████-████-██-██--████-██-███-███-█████-████████
---█-------█-------█-█---█-----------█-█-----█---------█---------█---█-----------------█-█---█-█-----
-███-█-█-█-█--██-███-█████-█████-----███-█-█-█████-█-█-█████-█-██-██-█-███-███-███-█---█-█-███-█-████
-█---█-█-█-█-█-----------█-----█---█-█---█-█-█-----█-█-----█-█-------█---█---█---█-█-█-----█-█-------
-███-███-█-█████-███-█---███████--██████-███████-█-█-█-█████-███-████---██-█-█-█-█████-█-███-█-████--
-█---█-----------█---█---------█-------█---█-----█-█-█-----█---█-----█-----█-█-█-█---------------█---
█-██-█-█-███-█-███-███-█████████-█---███-█████-███-███-█---█-█-█-███-█-██--███-███████-████-██-█-████
-█---------█-█---█---█-------█---█-█---█---------█-█---█-█-█---█---█---------█-----█---█-----█-------
-█---█-█-█-███--█--█-███████-███-█████-█-█-██-████-███-█-█-███--███-████-█-███-█---█-█-█-█-█-███-████
---█-█-█-█---█---█-█---------█---█-█---█-█-------█---█---█-█-------█-█-█-█---█---█-█-█-----█---█-----
-█████-█-█-█---███-█-█-███-████--█--██-███-█---█-█---█████-███-██-██-█-█-███-███-███-█---█-███--████-
-█---█-----█-█-█-----█---------█-----█---█-█---█-█-█-----█-█-----------█---█---█-------█-█---█-█---█-
██-█-█-█████-█---█-█-█-█-█████-█---███-█--█--███---█-█-███████-███████████-█-███-███-██--█-█████-████
---------█---█-----█-█-------█-█-█---█-----█---█---█-█---█-----█---------█-█-█---█-----------------█-
██-█----████-█-███-███-███----███-██-███-███-█████-█-█-█-█-█-██--██-██-█-█████---█-█-██----██--█-███-
-----█---█-------█-----█---█-------█---█-█-------█-█-█-█---█-----█-----█-----█---█-█-----█-----------
-█████-██----█-███-█-█-███-█-██--█-███-█-███-█-███-█-████-██-█-███-█-███-███--████---█-███-█-█-████-█
-█---------█-█---█-█-█---------█-█-----█-█-------█-----------█---█-----█---█-----█-█---█---█-█-------
██-█-█--█--██--███-██████-█-███-██-█████-█-██----█-█-█-█-███-----██--█-██-██-███-███-█-█-███-█-███-█-
-----█---█-█---█-------------█---------█-█-█---█-█-█-█---█-----█---█-------█-█---█---█-█---█-█-------
██--██-█-█-█-█-█-█-███-█-█-█-█-███-█-███---█-█-█████-█-█-█-██--███---█-█-██--█-███-███████-███-███-██
---█---█-█-█---█-█---█---█-█-----█-----█-█-█-█-------█-█---█-█---█---█-█-█-------------------█---█---
-█████--██-█████-█---█-███-███-███---█-█-█-█-███-█-█-███---█-██--███-█-█-███-██-█--███-█-███-██████--
-----█---█-█-----█-█-█-------█-█---█-█-█-█-█-█---█-█-█---█-----█-█-█-█-█---------█-█---█---█-----█---
-█-█---█████████---█-██████-█------███-█---██-████-█-██-██---████--█████---█-█-█-███-███-█-█-█-████--
---█-█-----█-----█-█-----█-----█-█---█-█-█---█---------█-█-█-----------█-█-█-█-----█-█---█-█-█---█G--
-█████-███-███-███-███-█-█-██-████-█-█-█-█-█-███-█-█-█-█-█-██████---██-█-███-█--██████████-█-███████-
-█---------█---█-------█-------█-█-█-█-█-█-█-------█-█-█---------█---█-█-█-------------█-------█-----
████-█████████-███-█-█-██--█--█--█---█-██-███-██-█-█--█--█-█-█-█-███-█-███████-██-█-██-█-█-█████--██-
---------------█---█---█---█-----█---------█-█---█-█-█---█-█-█-█---------█-----█---█---█-------------
-███-███-████--███-█---███-█-█-██-████-█---█-█████-███-███---█-█-█-█████-██--█-█-███-█-███-█-█-███-█-
---█-█---█-█---------█-----█-------█-█-█-█---█---█-█-----█-█-█-█-█---█-----█-█-----█-█-█---█-█-----█-
-███-█████-███-███--██-█-█-█-███-█-█-████████--███-█-███-█-█-███-███-█-█-█-█-█-██-██-██---██-█-██--██
-█---█-------------█-----█-█---█-------█-----█-█-█-----█-█-█---█-█-█-----█-█-█-----█-█-█-█-----------
█--█████-█-█-█-█-█████-█-█-██-██-█-███-█-█-█---█--██--██-███-██--█-██-██-█-█---███-█---█-███-█-█-█-█-
-----█---█-█-█-█---█-----█---█-█---------------█---█-█---------█-------█-█-█-----------█---█-█-█-█-█-
██---█████-█-█-███-█-█-█-█-█----████-█-█-███-█-███-█-███-█-██----█-█-███████-█-█████---█-███-█---███-
---█---█-----█-█-█-█-█-█-█---------█-█-█-----------█-█-█-█---█-█-█-█-------█-█-█-█---█-█-----█-█-----
-█-█-█-█-██--███-█████-█---█-███-█-███-█-█████-█-█-█---███-█████-█-█-█-█-█-█-█-█-█-███-██-██---██████
-█-------█---------█---█---█---█-█-----█-----█-█-█-█---█---------█-█-█-█-█---█-------█-█-----█-█-----
-███-█████-█████-█-███---███--████-█-█-███-█-█-███-█--██-█-█-█-█-███----██████-█████-█-███████-█-█-█-
-█-----█---█-----█-----█---█-█-█-█---█---█-█-------█---█-█-----█---█-█-█-------------█-█-█-------█---
-███-█████-█--██████████-███-█-█--████-█-███-█-███-███-█-█-███-████--█-█-█-█---█-█-███-█----██-█-████
-----------------█---█-------------█-------█-----█---█-█-█-█-------█-------█-█-█---------█---█-------
-█-█-█-█-█-███-███-██--█-█-█-█---███---█--██-███-██-██-█-█-███-███-███████-███-██--███-██--████--█-█-
-█-█-█-█-█---------█---█-█-----█-█---█-█-█---█---------█-█-------█---█-----█---█---------█-------█-█-
80 98