A--------█---█-----------█-█-█-█-----█-----█-------█-█-----█-█---█-----------█-----█-----█-----------
-███-███-█-█-█-███--███-██-█-█-█-█████-███████-█-███-█-█-███-█-█-█-█████-█---███-███-██--█-█████-██-█
-----------█-█-█-------█-----█-----█-█-█---█---------█---█---------------█-█-------------------------
██-█-█---█-█-█-█--█--█████-████--███-█-█-███-█-███████-███-█-█████-█-████-██-█████-█-████--█-█--██-██
-------█-----█-----█---------█-----------█-----█---------█-------█-█---█-█-------█---█---█---█-------
████-█-█-█-███-█████-█-███-███-██████--███-███████-███-█-█-██--████████--█-█-██████--█-█-██████-█████
-----█-█-█---------█-█-█-█-----------█-█-█-------█---------------█-------█-------█-------------█-----
██-█-█-█-███-██-██-█████-███-█-██-████-█-█--████-█-█████-█-█-████--█████-█-█-█-███-███-██-██████-████
---█---█---█---------------------█-█---█-------------------█---█---█-----------------█---------█-█---
██-█-█-████-██-█████████████████-█-█-███-███-███████████-█-██--█-█-█-██-██-█-███-██-█--█████-███-█-█-
-----█-------█-------█---█---█-█---------█-------------█-█-█-█---█---------█---█---------█---█-----█-
-██--█---██--███---███-█-█--██---█-█-███████-█████-█--████-█-█-█-█-███-███-█-█-█-█-███---█-█-█--████-
-█---█-----█---█-█---█---█-------█-█-------█---█---█---█-------█-------█-█-█-----█---█-------█---█-█-
-█-█-█-█-█-█████-█-███-███-█████-███████████████-███████-█-███----██████-██--███-█-██████--███-█---█-
-█-█-█-█---------█---█-█---█---█-----------█---█-------------█-------------█-█-█-█-----█---------█---
██-█-███-█-█---███████---███-██--████--████---██--██---███-█-█-███-█-████████--█--██---█---█-█-█---█-
-----█-------█-------█---█-█-█-█-------█-----------█-----█-█-█-----█-█-----------------█-█-█-█-----█-
-█-█-███-█---███-██-██-█-█-█-█-█-███████-███--████-█-██--████-████████-█-███---███-█████-█-█████-█-█-
-█-█---█---█-█-█-------█---█-------█-------------█-█-----█---█-------█-█-█-█-█---█-█---█-█-------█---
-█---██--█-█---███-█-█-█-█-█-███--████-█████-███-█-█████-█-█-███-██--█-███-█-██----███---███-███--███
-█-█-█---█-------█-█-█---█-------█-█-█-----█-------█---█-█---------█-------█---█-█-----█---█---█-█---
████-███-█-█-█████-█████-█-█-███-█-█---████-██-█████-█-█-█---█-█-███-█-█-████--█-███-█--██-█-█████-██
-█-------█-----------█-█-█-█---------█-█---█-█-█-█-█---------█---█---█-----█-█-█---█---█---█-█-------
---█-███---█-█-█-█-█-█-█████████---███---█-█-█-█-█-█-█████---███-█-███-█---█-███-███-█████-█---███-██
---█-█-----█---█-█---------█-█-----█-----█-----------█---█-█-█-█-█---█-█-----█---█-█-----------█-█---
-█-█-█-████--███-█-███-█-███-█-█-█-█-███████-█-██-██-█-████--█--█--███-█-█-███--█----███-███-█-█-██-█
---█-█---█-----█-█---█-█-█-█-------█-█-█-----------█---------█-----█-█-█---█-----------------█-█-----
█--████--███-███-█-█-█-█-█-█-███-█---█---██--███-████----█-█-█-███-█-█-█-███-█-███-█-█████-█-███-██--
-█-----█---█---█-█-█---█---------█-----█-------█-------█-█---█-█-█-----------█---█-------█-█-----█---
-█-███----██---███-███████████████-█████--██-██--█████-███-█-█-█---█-█-█████-█████-███-██--███-█-█-██
-----█-█-█---█-----█-█---------█---------█-█---█-----█-█-----------█-█-----█---█-----█-█-----█-█---█-
-█-█-███-█-█████-███----██-█-█-█-███-█-█---█████████-█████-█-█-███████-█-███-████--█-█████████-█-█-█-
---█-----█---█-----------█---█---█-----█---█---█---------█---█-------█---------█---█-----------█-----
█----███-█-█████-███-█-███-█-█-█-█--██-█-█-█-███-█-██--█-█--████-█-███-█-█-█-█-█-█-██-██-██-█████-███
---█-----█-█---------█-█---█-█---█-█---█-█-----------█-█-█-█---█-----█-█-------█-█-█-█---------█-----
-█-█-███████-██--██---██-█-█-███-███-████-██-█-█-█-███-█-█---███████████-██████-██-█-█-█-███---█-███-
-█---------█-█---█-------------█-----------█---█-█-------█-------█---█---█---------█---█-------------
--██-███---█-█-----█-███--██-█████-█-█████--██-███-█████-█████████-█-█-█-█-█-█-█-███-█-█-███-███-███-
-█-----█---█-█-█-------█---█---█---------█-█-----█---█-------------█-█-█-█-█-█-█-█-█-█-----█---█-█---
-█-█-█---███████-█-█-██--███-█-██--███████-███-██--█-█-███████-███---█-█-█-█-█-█-█-█-█-███-█-█-███--█
-█-█---█-------█-█-█---------█-------------█-█-█---█---------█---█---█---------█-------█---█-█-█-----
██---███-███--██-█████-█-███-█--██-████--███-█--██-█████---█-███-█-█-█-███-██████--█-███-█████-█-███-
---█---█-----█-----█---█---█-█-----------█-----█---------█-█-----█-█---------█-█-█-----------█---█---
████-█-███-█-███-█████-█-██████--███-█-████--█--████-█████-███--██-█-███████---█-█-█████-█-███-███-██
-------█-------█---█---█-----------█-█-----█-█---█-----█---------------------------------█-----------
-██--█-█---████-██--████-████████--███-████---█-██████-███-█-█-███-█-███-█--██-█-███-██--█-█-███-████
---█-----█-----█-█-------------█-----█---█-----█-------█-------█-█-█---█-█---█-█---█---█-█-█-------█-
█--█████-█---███-█-█████-█-██████--█-██--█--█-█--███-███-█████-█-███-█-█████-███--██-██--████████-██-
-------█---█---█-----█---█---█-----█---------------█---█-█-█---------█-█-----█---█-----█-------█-----
-█-███-███-█-█-█-█-██████--█--██-█-███--████--████████--█----█-███-███-█-███████-█-█-███-█--███---██-
-------█---█-█-█-█-----█-------█-█---█---█-█-----█-----█---█-█-----█-█---------█-█-█-----█---█-----█-
██-██-████-█-█-███-█-█████-█-█-█-███-█-███-███-██---██-█-█-█-█---███-█-██-██-█---█-█████-█-█-█-█-████
-----------█-----█-█-█-█---█-█-------█-------█-------█-----█---█---█-█-█---█-█-----------█-█-█-█-█-█-
--██-----█-█-█---█---█-██-██----███--███-█-█-████-███--█-███-█-█-███-█-█--█████████-████-█-███-███-█-
---█-█-█-█-█-█-█-█-█-------------█-------█-█-----█---------█-------------█-----------------------█---
-██-██-███--██-█-███-██--███-█-█-█-█-██--███████████-█-█-███-███████-█-██--█-█-█-█-█-█-█-█-█████-█--█
-█-------█-------█-----█-█---█---█-█-█-█-----█-█-----█-█-█-----█---█-█-----█-█-█-█-----█-█-█---█-----
-█████-███████-███-█---█-█████--██-███----██-█-█-█-█-█-███-█████-███-█-███-█-█████-██-████-█-██---██-
-█---█-----------█-█-█-----█-------█-----█---------█---------█-------█---█-----█---█---█-█---█-----█-
██-███-███████-█████-█--------██████-███-█-█--██-----██-█-██-██--█████████████-█-███-█-█-█-███-█████-
-█-------█-----------█---█-█---█-----█-----█---█-█---█-█---------------------█---------█-█-█-------█-
-███-█-█-███-█-█████---█-█--████████-█-██-██-█-███-█-█-█-███████-████-█████-█---██-█████-███-███-█-█-
-----█-█---█-█---------------------█-█-█-----█---█-█---------█-█-█-█-----█-█-█---█-------------█-█-█-
██---█-█-███████-███-█-█-██-██---█-█████---███-----█--██-██-██-█-█-█-█████---███-███-█-█----████-███-
-------█-█---█---█---█-█---------█---█---█-█---█---█-█-█-------█-----█-----█-------█-█-█-█-----█---█-
-█████-███-███████-█-█-███-█-██--████----█---█-█---█-█-███-███-█-██-██-█████--██-█-███-███-██-████-██
-█-----------█-------█---------█---█-------------█-█-----------█---------------█-----█-------█-------
██████-█-█-█-█-█---█-██-████-███-█-█-█-██--█---█-█-███-████--███-███-██-███-██-██-██---█████-█-██████
---█-█-█-█-----█-█-█-█---█-----█-█-█-█-█---█-█-█-█-█-----█---------█-----█---█---------█-█-------█-█-
-█-█-█-███-██████-██------██-██--█-███-██--█---█-███-█--████-██-██-██--█-█-███-███-███-█-███---███-█-
---------█-------█-------█-----█-------█---█-█-█-----█-----█-----█-█-------------█---------█-█-------
---███-███--███-██████-███-█████-███-█-███-████--█-█-█-███-█-█████--██-███--██-█--██-█-█-█---██-████-
---------█-█-----█---------█-----█-----█---------█---█---█-------█---█-------█-█---█-█-█---█---█-█---
██-█-██-█--██--█-█-█-█-█-█-█-█-██--█-█-██████--██--█-█-█-███-███-█████-█████████-███-█-█-█████-█-████
-------█---█-------█-█-█-█-------█---█-█-------█-------█-█-----█-----█-█-----█-----█-█-█-----█-------
-███---███-██████████----█-█---█-█-█-████----█-█-█-███████---█-█-█-███-█-█████-█-█████-█-█-█████-█-██
-----█-------█---█-----█-█-█-█-█-█-█-----█-█-█---█---█-----█-█-█-█---█---------------█-█-█-------█-█-
-█-█--█████-█-██-█████-███-██-██-█████-█████-██--█-███-█-█████-██--█████-███-███---█-█-███-█-█-█████-
-█-█---------------█---------█-----█-------█-█---█-----█---------█-----█-----█-█-█-█-█---█---█-█-----
-█-███-██-████---███-█-███-███-█-█████-█-█-███-█-█-█---█-█-██-██-█████-█-█--██-███-█-█---█-█-█-█-███-
-█---------█-------█-█-------█-█---█---█-█-█---------█---------█-------█-----------█---█-█-█-█-█-█-█G
██-█-███-█-█-█-█-█-█-███-███-█-████-██-█-███-███-█-██-██-█--████-███---█-██-██████-----█-█-█-███---██
---█---█-█-█-█-█-█-█-----█-█---█---█---█-█-------------█-█-----█-----█-█---█-█---█-█-█-█-----█-█-█-█-
-█████████-███████-███-█---█-█---███████--████-█-█-█-█-██--████-█████--███---█-██-██-███████-█-█-█-█-
-----█---------█-----█-------█-----█-----------█-█-█-█---█-----------█---█---------█-█-█-█-█-█-█---█-
-█-█████---█--██-█-███████-███-█-█-███-█████-█-█-----█-█████-███-█████-███-████████-██-█-█-███---███-
-█---█---█-█-----█---------█-----------█-----█-----█-█-----█---█---█-----█-█-█---█-█---█---█---█-█---
-█-███-███-███-█-███-███-█-███-███-█████-███-███-█-█-█-███-█-█-███-███-█-█-█-█-█-█-█-███-███-██--█-█-
-█-----------█-█-------█-----█---█-█-----█-█-----█-█-█---█-█-█---█---█---------█-----------█---------
--█-██-███-█-█-█-███--████-█-███-█-█-█████-█-███-███-█-█-█-█████-██---██-███---█-█-███-█-███-███--█--
---------█-------█---------█---█-█-█-█---------█-█---█-█---------█-----█---█-█---█---█-█-----------█-
-█-███-██--█-█-█-███-███████-███-█-█████--██-███-███-███████████████-█-█-███---█-█-███---█--████-█-█-
-█-█---█---█-█-█-█---------█-------█-█-----█-------█---------------█---█---█---█-----█-█-█-----------
-█-█-█--██████-█-█████-███-█-█-█-███-█-█-███-█-███-███-███-███-█--██-█████████-██--███-█-------█-████
-█-█-----------█-------█-█-█-█-█-------█-█-------█---█-█-----█-█---█---█-█---█---█-█---█-█-█-█-█-----
████-███-█-█-█-███-█-█-█-█-█--------██---█████-█-█-█-█-█████-█-█-███-█---█-███-███-█--████-█---█-█-█-
-----█-----█-█-█---█-█---█---█-----█---█---█---█-█-█-█---█---█---█-█---------█-█-█-█---█---█---█-█---
-█-█---█---█████-█-███-███-█-----███-█-█████-███-█-█-███-█-███████-███-██--███-█-███-███-███-█---█-█-
-█---█-█-█-----█-█---█-█---█-█-----█-█-█---------█-█---█-█-------█-----█-█---█---█-█---█-----█-█-█-█-
-█-█-█-██----█--█----█████-█-█-█████-███-█-███-█---█-█-███████-███-----█-█-███-█-█-█-███-█--█--█-█-██
---█---█---█---█---█-------█-█---█-----█-----█-█---█-------█-------█---------█-█-------█-█-----█-----
80 100