A--------█-█---------█-█-█-----------------------█---█---█-█-█---------█-█-----█-█-------█-----------
-██--█-███-█-███-██-██-█-█-█-█-███-████████-██████-███-██--█-█---███████-█-█████-███-███████-█████-█-
-----█-█---█-█-█---█-█---█---█---█-----█-█-█-█-█---------------------------█-█-----------------------
-███-█-█-███-█--██-█-█-███-█████-█-█-█-█-█---█----██-██-████-█-█-█-█████-███---█████-█████-█-██--███-
---█-█-------█-█-█-----------█-█---█-------█-------█-█-█---█-█---█---█-----█---█---█---█-█-█---█-█-█-
-███-█-██--█-█---███████████-█-█████-███-█-█-███--███-----██████████████████-███-█---███-███████-█-██
-----█-█-------------------█-------█---█-----█-█-█---------------█-----█---█---█-█-█---█-----█-------
-██--███-█-███-█-███████-█-█-███-██-███--█--██-█-█-█-███-███████████-███-█-██--█-█-█-███-█-███---█-██
-----█-------█-█-█-----█-█---------█---█-█-------█-█-----█-█-█---█-----------█---█-█-----█-----█-█-█-
-███-███-█-█-█--██-███-███-█████-█████-█-█-███████---███-█-█-█--██████-█-█-███--██████-█---█-█-███-█-
-----█-----█-█-----█---------█-█-----█-█-----█-----█-----█-█-----------------█-----█-----█-█-█-------
████████-██-██-█-█-███-█-█-███-█-█-███-█-██-██--█-████-███-█-█-█████-█-███████-██-██-█-█████████████-
---█-------█---█-█---█-█-------█---------------█-█-----█-----█-----█-█-█---█-------█-----█---█-----█-
█---████-█--██-█-███-███-█████-█-█████-█████-██--█-█████-█-███████-██-██-███-█████-█--████-██---██-█-
---█-----█-█---█-------█---------█---█-█-█-█-------------------------------█-----█-█---█-----█-------
-█-███-█-██--█-█-██-██-███-█-█-███--████-█---█████--██████-███-█--███--█-███---█-█---███-█---█-█-████
-----------█-█-█---█-█-----█-█-------------█-█---█-----█-----█-█---█---------█-█---------█-█-------█-
-█-█-█-█████-█-█--██-█--██-█████-█-█-███████---█-████--███-████-██-█-███-███-██--████████-██-███---█-
-█-█---------█-█-----█---█-----█-█---------█-----------█-----------█-█---█---█-------------█-----█---
--██-█-███████-█-█-█-█████-█-███-███-█-███████-█-███-█-█----█-████-█-███-█---█-███-█---███-█-█-███-█-
-█---█-----█---█---------█-█-█-█---█---█---█-------█-█-█---------█---█-█-█-█-█---█-█-----█-█-█-█---█-
-█████-█-█████-█-█-███-█-█-█---███-█-█-█-███-█-█-█-███████-█--██████-█-███-█-█--██████-███-█-███-█-██
-------█-█-----█-█-█---█---█-----█-------█-█---█-█---█---█-█-----------█---█---------█-----█---█-█---
-███-███████-█-█-█-███-█-█-█-█-█-████--███-█████-█-█-█-█-█-██---██████---██--███-█-████--██████--█---
-█-█-█-------█-█-█-█-█-█-█-█-█---█-█-----------█-█-----------█---█-█-█---█-----█-█-----█-----█-----█-
█--█-█-█-█-█-███-███-██-████-█████---█-█---███-█-█-███-███████-----█-██████--█-----████████--█-███-██
---------█-█-█-----------------█-█---█-█-█-█---█-█---█-█-----█-█---------█-----█-----------█---█-█---
████-███-███-███-█-█-███-█---█-█-███---█-█████--█----███-█-█-███-███-███--███--█████-█████-█-█-█-████
-----█---█-----█-█-----█-█-----------█-█-----█-█-█-█-█---█-█-█---█-----█-█-█-------█-------------█-█-
██-█-█---█-█--█--█-█-█-███-█-█-█-██-████-██████--█████-███-███--██-███████-█-█-███-█---█-█-█████-█-█-
-█-----█-█-█---█-█-----█---█-█-█-----█-----------█-█-------█-----█-----------█-█-█-█-█-█-█-----█-█---
-█-█-███-███---█-█-███---█-█-█-█-█-████--█-█-█-█-█-█-█████---█--██-████---██████-██-████████-█-███-██
-------█-█---█-█-█---------█-█-----█-█-█-█---█---------█-----█-----█-█---█-█---█-█---█---------------
-█-█-█-███-███-█████-██--█-█-███-███-█-█████-████--███-█--████-█---█---███-█-██--█-███-██-██-█-█-█-██
---█-█-█-█-----█---█-----█-█---█-------█---█-----█---█-----█---█-█-----█-----------------█-----█-█---
-█-█-███-█-███-█-███-█---███-█-█-██--███-██--█████-█-███-█-█-█-█████-███-█-█-█-█-███-█-█-█-█████████-
-█-█-----█-------█---█-█---█---█---█-------█-█---█-█-----█---------█-----█---█-█---█-█---█---------█-
-█-█-█-███-██--█████████-█-█-███-█-█-█-█-█-███-█████-███████-█-█---███-█████-█-█-██-----██-███████-██
-█---------█---------█---█-█-█---█-█-----------█---█-█-------█---█---█-----█---█-█-█-█-----█-----█---
-█-█-█-███-███-████--█-█████--██-███-█-█████-█-█-███-█-██--█---████--██--█-█-██--█---█████----██--██-
-█-█-█-----█-------█---█---█---█-█-█-█-------█---█-█-------█-█---------█-█-█---------------█-█-------
-█-█-█-█-█-████---████-█-█---█-█-█-██████-██-█-██--██-██-█-█-█████-███-███-██--█---█-█-█---█-█--████-
-█-█---█-█---█-------█-----█-█-----------█-█-----------█-█---------█-----------█-█-█---█-█-----------
-███-█-██--█-█-█-███-█-███-█-█-█-█-███████-█-███████-███-██-██-█-█-███-███-███--████--████-█████-███-
-█---█-█-█-█---█-█---█---█-█-█-█-█-----█-----█-█---█-█-█-----█-█-█---█---█-█-------█---------█-----█-
█████----█--██-█-█-███-███-█████-█-███-█-█████-█-█████-█-███-███-███████-██-█--█-█████-█████-███--███
-------█-----█-█---------█-----█-█-----------█---------------█-█---█-█-------█-█---------------------
-███-█████--██-███████-█-████-██-███-███---█-█-█-█-█████-█-███-█████-██--██-████-███████-█████-███-█-
-█---█-█-█-█---------█-█---------------█-█-█-------█-----█-------█---------█-█-█-------------█-------
████-█-█---█████-------█-█-█-█-██-██-█-█████-█--████-███-█-████-██-█████-█-█---███-█-█-██-████████-█-
-------------█-----█-█-█-█-█-----█-----█-█---█-----█-█---█-----█-----█-----█-█-----█-█-----------█-█-
██-█-█-█-█-█-███--████-███--██-█-███-███-█-█-███████-███-███-█-█-██-██-█-███-█-█-███-██████-█-█--████
-----█-█---█-----█-█-█-█-----█---------█-------------█---------█-------█---█-------█-----------█---█-
---███-█-█-█-█-█-█-█-███-█-█-███-█-███--██-█-█-█████-█-███---█-█-███████████--████---█-█-█-█-█-███---
-█-█---█-█---█-█-----------█-----█---█-█---█-----█-█-█-----█---█---------█---------█-█-----█-█---█-█-
-█-███-███-█-█---█-█-████--███-█-█-███--██---███---███████-█-███-███-█-██--█-█-█████-█████-███████-█-
-█-█-----█-█-----█-----█-----█---█-█-----------█-----█---█-------█-█-█-█-----█---█---█-█-█-█-------█-
-███-█-█-█-█--██-█-█---█---████-██████-███-█-█-█-███---█-█-███-█-█-█████-█-█-█-█-█-███-█-███-██-████-
---█---█---█-█---█-█-█---█---█-----------█-█-█-█---█-----█---█-----█-----█-█-------█-------█-█-█-----
--██-█-█████-███-██---██████-█-█████-███---█---█-█--██-█---█-█-███-██--████-██---█████-█--█--█-█-███-
---█-█-█-------█---█-------------█-------█---█-█-----█-█-█-█---------------█---------█---█-----------
-█-█-█-█--████-█-████-██-███--██████-█-█--██-████--████-██-█-█--██-█--████-████----█-█-█-█████-█-█-██
-█-█---█---█---█---█-█-----█-----█---█-----█---█-----█---█-█-█-█---█-----------█-█-----█-----------█-
██-███-█████-█---█---██--███-█-█-█-█-█-█-██--████--███-█████----█---██-███-█-███████-█████-███-█---█-
---█---------█-█-█-----█-█-----█-█-█---█-█-----█-------------█-█---█---█---█-----------█-----█---█---
-███-█-█--████-█---█-██--███-█-██--█--██-█-█-█-█--██-█--██-█-█-█-█-███-███--██-█████-███████--██---█-
-----█-█---█-█-█-█-█---█-----█---█-█-█-------█-█---█-█---█-█-█---█-█-█---█---█-█---█-----█-----█-█---
██-█-█-█-█-█-██--█-█████-----█████-███-███-██--█-█--██--██----██-███-█-█████-███-█████████-█-██--███-
-----█-█-█-█-----█-----█-█-█-----------█---█---█-----█---█-█---█-█-█---█---█-----█-█-------█-█-----█-
-███-███████---█-█-█████-██-████-█-█-███-███-█-█████-█-█-█-█-█-█-█-█-█-█-███--█-██-█-█-█-███-███-███-
---█-----█-█-█-█-█-----█-----█-----█-█---█-█-----█-█-█-█-█---█-█-----█-------------█-█-█---█---------
-█-██-████-█-█-███-██-████-█-█-█-███-██--█-███---█-█---█--██-█-█████-███-█-██--█-█-█-█████-████--█-█-
---█---█-----█---█---------█-█-█-█-----█-█-----█-----█-█---█-█-█-█-------█---█---█-------█---█---█-█-
-█-███---█████-███-█-█-███-█-█---███-███-███-█████-█-███-█-█-███-██--█-███████-█-█-█-█████████-█-████
-█---█---█-----█---█-------█-█-█-█---█-----█-------█---█-█-----------------█-----█-█---------█-█-----
-█████-█-█-█-█-███-█-█-███--████-███-███-█-███-█-█-███----██-███████----████████-██--████-███--███-██
-----█-█-█---█-█---█-█---█-----█-------█-------█-█---█-█-----------█-█-----█-----------█-----█-█-----
-█-█-█---█-████-██-███-█-███████████--████---█-███-███-█-███-████--█-█████-█-█-█-███-███-█-████-██-█-
---█-█-█-█---█-------█-----█-█---█-------█-█-█---█---█-█-█---------█-----█-█-█-█-█-----------█---█-█-
██-█████████-█-█-█████-█-█-█---██--█-███-█-█-█-█-█-█-███-██---██████-███---██-██-███-█-███-█-█-███-█-
---------█-----█-------█-█-------█-█---█-----█-█---█-█---█-------█-----█---█-------█-█---█-█---█-----
-█-███-█-█-█-███-----███-███-███████-█-██████--█-███-███--██-█-█---███-█-███--█████--█-█-█-█-█-█-████
---█---█---------█-█-█-----------█-----█---█---█-█-█---█-----█-------█-█-█---------█-█-█---█-█-█-█---
██████-█-█-███-█-█-█-███-█-███--████--████-███-██--█-█████-█-█████-███--██-█-█-█-█-██-██---█-█████-██
-█-------█-----█-█-█-█-█-█-█---------------█-------█-----█-█-----█---█---█-█---█---------█-----█-----
-█-███-█-█████-█-█████-████--█---█-█-█-█-█-███-█-█████-█----██-█-█-█---█████-███--██-█-███-█-███--███
-------█-----█-█-------------█-█-█-█-█-------█-█---█---█-█-█-----█-█-█-----█-------█-█-----█---------
-██--██--█-█-███-█-███-█-█-█-█-█████-█-███---█-███████-████-██--██-█-█-███-█-███-█████-███---█-█████-
-█---█-----█-█-------█-█-----█---█-----█---█-----------█---------█-█-----█---█---█---------█-█---█---
-██-██-█-█-███-██--███-█████-█-███-█-█-███---█████-█-█-█-█--██-█-█---██--█████-█-█-█-█-█-██-██---█-██
---█---█-█-█---█---█-------█-------█-------------█-█-█---█---█-█-█-█--G--█-█-----█-█-█---------█-----
-███████-█-█████-█-███-███████-███-██--██-█-██-███-█--██-█-█-███-███---█-█-███---███-█-█-███--████-██
---█-----█-█---█-█---█-----█-----█-█---------------█-------█---█---█-----█---------█-█---------------
-█-█-███-███-██--█-█-█-███-█-█--██-██--█-███-█-█-█-███-█-███-███-█-████---█--█-██--█-█-██████--█-█-██
-█-█-█-------------█-█---█---█-█-█---------█---█-█---█---------█-█-------█-------█-█-█-------█-█-█---
-█-█---███-█-███-█-█---███---█-█-█-███-█-█-█-█-█-███-███-█-███-█████--██████-█-█-█-█████-█--██-█-█-█-
-█-█-------█-█-█-█-█-----█-█-----█-█---█-█-█---█---█---█-█---█---█---------█-█---█-----█-------------
██-█-█-█████-█-███-█-███-█-█-█-██-██████-███-█-█-███-███-█-█-█---███-█-█---█---███-████-█-----█████--
---█-█-█-------------█---█-█-█---█-█-█-█-█-█-█---█-----█-█-█---█-█-----█-█---█---------█---█-█-█---█-
-█-███-█-███-█-███---█-███-█████-█-█-█-█-█-█----██-█-███-███-███-███-████--█-███-███---█-█-█-█-█-█-█-
-█-█---█---█-█-█---█---█-------------------█-█---█-█-█-----█---█-█---█-------------█-█-----█-----█---
90 70