A------█-------█-█-█---█-█-█---------------------█-----█---------█---------█-------------------------
-█-███--█--█-██--█-█-███-█-█-█████-█-███-█--██-██-████----██████---█-███-█-█-█-████-████████-█-██████
-----█-------█-------█-------█-----█---█-█---█-█-----------█---█-█-------█---------█---█-----█-█-█---
-█---███----█--███████--████-█--██-█████---█-█-██--█████-███-█-█-█-█--█--█---████-██-█████-██--█-██--
-█-█-----█-█-█-█---------█-█---------█-█-█-█---█-------█---█-█---█-█---█---█---█-------█---█---------
-███-██--█-█-█-███-█-█-█-█-█--██-██-██-█-█-█████--██-█-█---█-████--█-█-█-█-███-█-███--████-█-███████-
---█---█-----------█---█---█-----------------------█-█-------█-----█---█-█---------█-----------------
██-█-█████-███████--██-███----█--█----█████-██-██--█-█████-█-█-█-█-█---█████-███-█-██-████-█-██--███-
---------█-----------█-█---█-----█-█-------█-█---█-█-█---█-----█---█-█-----█---█-█-------█-█-----█---
-███-█████-█-█-█████--██-█████-██--█-███-█-█-███████-█--██--██--██████-█-█---█---█████--██-███-█-█-█-
---█-----█---------█-█-█---█-------█---█-█-------------------█---█---█-█-█-█-█-------█---█---█---█-█-
-██--█████-█████-███-█-███████-██--███████--██-█████---████----█-█--█--███-███-███-█████-█-███████-█-
---█-----------█---█---█---█---█---█-█---█-█---------█---█-█-------█-█---------█-█-------█-------█---
-█-█-█--█████-████████-█-█-███-█-███-█---█--████████-█-█-█-████████----███████-█-███-█████████-████--
-█-----------------------█-█---------------█-------█-----------█-----------█-------█---█-█-------█---
-██--█████-█-████-█████--█-███-█-██--█-█████-█-█-█-█-█-----█████-███--██-█-█-███-███████-█-███-███-█-
-█-----█---█---█-------█-█---█-----█-█-------------█---█-----------█---█-█-█-----------█-----█-█-█-█-
-█████-██--█---█-█-█-----█-█████-███-█-██-████-█████████-█-█████-█████████-█-----███--██--███--█---█-
-█-------█-█-█---█-█-█---█---█-█---█-█-------█-----------█-----█---------█-----█-█-█-█-----█-█---█---
-█-███-███-█-█-█-█-███-███-██--█████---██--███████████-█-█-█-██---████████-█-██-█--█-█-█--██-█--██-██
-█-█---█---█-█-█-█---█-█-----------█-█---█-------------█-█-█---█-----█-----█-----------█-█-█-----█---
-█-██-██-██----███████-█-█-█████-████-██--█--█-█-█-█-█-█-█--█--█-█-█-█-███-█████-█████-█-█-██--███-██
---█-----█-█-█-------█---█-----█-█-█-------█-█-█-█-█---█-------█---█-------------█---█-█-█-----------
██-█████-█-██---██-███-██--███-███-███-███-█-█-███-█--██-█-██-███████-███-█-██████-███-█-█████-█-████
-----█-------█---█-----█-------------█-------█---------█-----------█-█-█---█-█-----█-----█-█---------
-███-█-█-█-█████████████-█-███████-█-███-█████-█████--██--████-███-█-█-█-█-█-█-█-██-██-███-███-█████-
-█---█---█-----█---█---█-█---█-----█-█-------█-----█-------------------█-----------------█---------█-
-█-███-█-█-███---███-█-█-█████-█-----████--█-█-███████-█-███-███-█-█-█---█-███--█--███-██--█-█--█████
-------█---------------█-------█-█-█---█---------█-----█---█-----█-█-----█-----------------█-█-------
██-█████-█-█████--████-█████---█-█████-███---█-█----█-██-█-███-█-█---███-█-███--███--█-███-███--████-
-----█-------------------------█-----█-----█-█---------█-█---█-----█---█-█-------------█-----█---█---
█-██---█--██-█-█-█████-███-█-█-███████-█████--██-█-████████---████-███-██████--███-███-███-█-█---█---
-----█-█-█---█-█-----█-----█-█-------█-------█-█-█---------█-█-█-█---█-----█---█-----█---█-█-█-█---█-
-█-█-██████----███████-█-█-█-█-█--██-█-███-███--██-█---██-██------████-█████-█-█-███-█████--████-██--
---█-█-----█-█-█-----█-█-█-█---█-█-------------█---█-█-----█-█---█-----------█-█-█---█---█---------█-
████-█-███-█-█-█-█-█-█-█-█-█-███-█-█████-█-███-█████-█-█████-███-█--████-███---█████-█--██-███-█-███-
-█-█-----█---█-------█-█-------█-------█-█---█-----█---█-█-------------█-█---------█-█---█---█-----█-
-█-█-█-███-███-██--███--██-█████---███████████-█-█-█████-███-----█--███---█--█-█-████--██-███████████
---------█---█---------█---------█-----------█-█-█-------█-------█---█-█---█-█-█---█-----------------
██-█-█-███-███-███-███████-█---█--██████--████-█-█-█-████████--██-████-█████████-█████-█-█-█-████████
-█-█-█-------█---█-█-----█-█-█-█-------█-----█-█-█-█---█-----------█-█---------█-█-█---█-------------
-██--███-████-██-█-███--████-██-█--█-██--█-█-█--██-█-█-███-███-███-█-█-███-███-███-█-███-███████-████
-------------█---█---------█-----█---------█-----█---█-█---█-----█-------█-█-█---------------█-█-----
-███-█████████--██-█-███-█-█-███-█-█-█-███-█-█-███-████--█-███-█-███-█-█████-█---███-█---███-█-█-███-
---█---------█-█-------█-█-█---█-█---█---█---█---█-█-------█-█-█---█-█-----------█---█-----█---------
-█████-███-█-█████-███████-███-███-█-███---█-█-███-█-█████-█---█---███-████--███████-█---█-██████████
-----█-█---█-----█-------█-█-█---█-----█-█-█-█---------------█-------█-----█---------█-█-█-█-------█-
-█████-█-█--███-██-█---█-█-█-█-██████-██-█--███-█-████-███-█---█--██████████-██---█--█-██--█-██-█-██-
-----█-█-█---------█---█-█-█-█---------█-------------------█-█-█---------█---█-█-█---█-█-----------█-
-█-█--██-█-█-█-█-█-█-█-████--█-███-█--█--███-█-█--██-███-█-█-█-█-███-█-█-██--█-███---█-█-█-█-█-██-██-
---█-------█-█-█---█-█-------█---█-█-----█---█-█-█-----█-█-█-█-█-█---█-----█---█-█-█-------█-------█-
██-█-█-█-███-██--███-█-███--████-█-████-██-█████---█-█████-█-██-████---█-███-█-█-------█-█-███-███-█-
-----█-█-----█---█---█---█-------------█-----------█-----█-█---------█-----█-█---█-█-█-█-█---█---█---
███--█-██████-██---█-██-███--█████-███-█-███-███████-█████-█-█-███-█-█---█-███-█████-█-█-███-█-███-█-
-----█-█-------█-█-█-------------█-█-------█-█-----█-----█-█-█-----█-█-█-----█---------█---█-█-█-----
██-█-█-█-█---█-█-█-█-████-██-█--███-██████-██-███--███████---█-█████-█-█-█-████-██-██████████████████
---█-█-█-█---█-----█-----█---█-----------█-----█-----█---█-█-█-----█-█-█-----█---------------------█-
██████-█-██████-██-███--███-██-█-███-████████-██--███--█████--█--█-██-████-█████---███-██--█-███████-
-----------------█-█---------█-█-----█-█-----█-------------------█-------█-------█-█---█-█-█---█-----
---█-█-█-███-█-██--█-█-███████-█-█-----█-███-█-██--█-█-█--██---█-███-█-█████-█-█-██████--█---█-█-████
---█---█-█---█-█-█-█-█---█-------█-█-------█---█-█-█-█-█-----------█---█-█-█---█-------█-█---█---█---
-████--█████████-█-█████-██--█-█-█---█--████-█-█-█-██--███---█-█-███-███-█-█-███-██-████-█-████-██-█-
-----------------█-------█---█-----█-█-█-█-------█---█-█-█-█-█-█---█-------█-█-------------█-----█-█-
██-█---███-██--███████-█-█-███-█-█-█-██--█--██-███--██-█-█████-██-██-█-█-█--██████--██-█-███-████----
-----█---█-------█---█-█-------█-█-----------------------█---------█-█-█-█-----------█-------------█-
-█-███---█-█-█-█-█-█-█--██-██-██--████-███-███--████-███-██--█-█-█████---██--█-█-████-██-█-█████████-
-█---█-█---------█-█-----█-█-------█-█---█-█-------█---█-█---█-█---█-█-█-█-█-█-█-------█-█-----------
-████-██---█████-█████-█--██-█--██-█-█-█-█-███-███-█-█-█-█-█-█-█-███-█████-█-█████-█-█-███-███-█████-
-----█---------█-█-█---█-█---█---█---█---█---█-------------█-█-█---█-------█-----█---█-█-█---█-----█-
-█-███-███-█--█-██-█---█████-███-█-█-█-█-█-█-███████-██--███-██--█---███-████---████-█-█---███-██--██
-█-------█-----█-----█---█---█---█-█-█-█-----------█-----█---█-------------------------------█---█---
██-█-█-█--██-███████-█-█----█--█-███████-███-███████---█-██--███-███-█-█████-█-█-████-████-██████--██
-█-█-█-█---█-----█---█---█---█-█---█-------█---------█-█---█---█-█---█-----█-█-----█-------█---------
-█████-█-█-█-█-███-█-█-█-█-███-███-█-███-███-█████████-█-█-█-███-█████-█-███-█-███-█-█-███---█-███-██
-------█-█-----█-----█-█-------█---█---█-█---------------█-█---█-----█-█---█-█---█---█-█---------█---
---█-█-█-█-█-███-█-█-███-█████-█████-█-███-█-██-█-█-██-███-█-█-█-█-████-██-██-██-█-███████-███-██████
---█-█-█---█---█-█-█-------█-----█-----█---█-------█---█-█-█---█-█---█-----█-----█-------█---█-----█-
██-█-█████---██-██-█-███-█-███-███-█-███-█-█-█-██-----------████-█-███████---████--███--██-█-█--██---
---█---█---█-█-█---█---█-█-█---█---█---█-█-------█---█---------█-█-----█---------█---█-----------█---
██-█-███-███-█-█---█-███████----██-█--████-███---████████-█--█-██--█-█-███-███---█-███-█-█-█-███-████
---█-█-----█-█---█-█-----█-█---█-█-█---█-----█-----█---█-█---█---█-█-█-------█-█-█-----█-------------
-█-███-█-█-██████--██-████-█-█-█--██-█-█--██████-███-███-███-█-█-███-█-█-███-█-██---██-█-█---██--█-█-
-----█-█-█-█-----------█-----█-----█-█-█---█-█---------█---█-█-----█---█-█---█---█---█-█-█-█-----█-█-
-█-█-█-███-█-█-█-█-█-█████████-█-█-█-█-█-███-█-█-█-███-█---█████---█-███-█-███-█--██-█-█-█-█-█-█████-
-█-█-█-█---█-█-█-█-█-----------█-█-█---█-█-------█-------█---█---█-█---█-█---█---█-█-█-█-█-█-█G--█-█-
-█-███-█-█-█-█-█████-███████-█-█-███████-███-██--█-███-█-█████-█---█-█████---██--█-█████--██-█████---
-█---█-█-█---█-----█---█-█-█-█-█---█---------█-------█-█---------█-█-█---------------█-------------█-
-█████-█-------█-███-███-█-█-███-██--█-███-█████--█-██-██████---████--██-█--████-█-█████-█-█-█-███-██
-----█-█-█-█---█---█-█---█---█-----█-█---------------█-----█-█-------█-█---█-█-█-█-█---------█---█---
██-███████-███-█-------█-█--█--███-███████-█-█-█-██████████--█████-███-█--█--█-█--██-█████-██--██████
-------█---█---█-█-█---█-█---█-------█-█---█-█-█-█-----------█-----█-█-█---------------█---█---█-----
-███-█-█---██--█████-█-█████-█-█--██-█--█-██---█-█-█--██-█-███--████-█-█-███---███████████-███-█-█-██
-█---█-█-█---█-█-------------█-█---█---█-----█---------█-█-------█-------------------█---█-█-█---█---
-█-█████-█-█-█-███-█-█████████-█████--██████-█-█-█---███-█-█-█-█-███-█████-███-█████---█████-█████-█-
-█-----█-█-█-█-█-----------█-█-█-------------█-█-----█-------█-█-----█---█---█-█-█-█-█---█-------█---
--██-█---███-█████-█-███████-███-███---█---█-█---█-█-███-█-█-███████-█-█-█-█--██---███-█-█-█-█-█-██--
-█-----█-------█---------------█-█---█---█-█-█-█-█-█-----█-█---█---------█-█-------█-█-------█---█---
-█-----████--█-███-█-█-█-███-███-███-█-███-███-█-█████████-█-██--███--██-█-██--█-█-█---█-███-██-████-
-█-█---█---------█---█-█-------█---█-█-█-----█-----------------█-------█-█---█-█-█-----█-█-----------
-█-█---█-█-█-█-----█-███-█---███████-█-----███-███-█-███-█-█-███████-█---█-█---█-███-█-█-███-█-█---█-
---█-█-█-█-█-----█-█---█-█-█-█-------█-█-█-█-----█-█-----█-█-█-----------█-█-█-----█-█-------█-█-█---
84 94