A--█-█-------------------█---█-█---------------------█---------█-----█-█---█-------█---█-------------
--██---█-███████-█████████-█-█-█--██-███-█-██--███████--████████-█-█-█-███-█--███-████-█-█-█-███-███-
---------------█-------█-█-------█---------█-█-------█-----█---█-█-█---█-------█---█-█---█-█-█-█-----
-███--█-████-██--████-██-█-███████████-█-██---█-██████-█-███-███-██-██-███-███-█-███---█--████-█-███-
-------█-█-------█---█-----------█---█-█-------█-█---█---█-------█-----█-------█---------------------
-█-█-███--██-███-█--██-███-█████-█-████-██-█-------█-█-███-███--██-██--███-█████-██-██--█--█████████-
-█-█-----█-█---█-----█---------█-----█-█-█-█-█-█-█-----------█-█-----█---█---------█-----█-----█---█-
-█-█-█-█-█-█-█-█-███----█--███-█-█████-█-█████---█-███-█-█-█████--██████-█-█-███-█-█-██--███-███-████
-█-█-█-█-----█---------█-█-----------█---█---------█---█-█-------█---█-----█-█-█-█-------█-█-----█---
██-███-████-████-██--███-███-███-██--███-█---█████-█---█-█████-█████-█--████---█-█-█-█████-███--██-██
---█---------------█-------█-█-█-█---█-█---█-------█---█-█-█-█-█-█---------█-█-------█-█-█-----------
████-█-█-█-███-██--█-█-█-███-█-█-█--██-█-███-█-███-███████-█-█---█-----█-█---█--██████---█-████████-█
-------------█-█---█-█---█-----█-█---█---█-------█---█---------█---█-█-------█-█---------------------
-███---█-█--████-█-█-█████-██-██-█-███-█--██████--█████----█████-█-█-█-██-█--█-█-███████--█████████-█
-█---█---------█-█-█-----------------█-█-------█-█-█-█-----------█-█---█-----------------------------
-█-███-█-█-███████████-███-██-████-███-███-█---███-█-███-█-████-████-███-█-█-█-█-█---█-█-██████-██-██
-█-█---█---█-█-█-█---█---█---█---------█-█-█-█-----█-----█---------█-----█---█-█-----█-█-------█-----
██-█-█-█---█-█-█---██--█--██-█-███-███-█-██--███████████-█-----███-█-█-█-█-███--██████-█-███-█--██-█-
---█-█-----------------█-█-------------------------█-----█-█-█-█---------█---█-█---------█---█---█-█-
-███-███-█-█-███--██-███████-█-███-█-█--███████-████-███-█-███████████-███-█████--████---███████-█-█-
-----█---█-█---█-█-----------█-------█-█-------------█-------█-------█-█-----█---------█-----------█-
-███-█-█-█-█-███--██---█-███-██--███-█-█-██-██-███---█---█████-█-█-█-█████-█-█-█-█████-█-███---█████-
-----█-█---█-----------█---█-█-----█-------------█-----█-----------█---█-█-█---█---█-----█-█-█-█-█-█-
████-███-█-█-███-█-████-██-█-█-██-██-█--████-█-█-█---█-█-█-█-█-███-██--█-█-███-█-█-█-█████-█-█---█-█-
-----█---█---------█-█-----█-█-----█-█-█---█-█-█-█---█-█-█-█-█---█---█-------█---█-----------█-█---█-
-█---██-██-█-███-█-█-███-█-█-█-█-█-█------███-██-███████-█-█-███-███-█---███████-██---██-█-█-█-█-████
-------█-█-█-----█---------█-█-█-█-█-----█-█-█-█---------█-----█-------█-█-█-█---█-█---█-█-█---------
████-█-█-█████-███-█-█--██--██-█-████-██-----█-█-----███-█-███-█████-███-█-█-----█-███-█-███--████-█-
-----█-------█-----█-█-█-------█---█---█---█-█---█---█---█-------------------█-█-----█-█---------█-█-
██-█-█-█-█-█████-███--██-█-█-█-███████---██--█-█-█████-███-██--█████-█-█-█-█-█-██--███-█-██-█---██-█-
---█---█-█-----█---------█-------------█-----█---█-------█-█-█---█---█-█-█---█-█-----█-------█---█---
-███-█-█████-█-█-█----██-█-███-███-█-----████--██--█--██-█-█--██-█--████████████-███-███-█████-█-█-█-
-█---█-----█-█-█-█-█-█-----█-█-█-█-█---------------█-----█---█-█---█-█-█-------█-----█-------█-█-█-█-
-█-███---█████-██-██---█-█-█-█-█---███-█-█-█-█--██████████████-███-█-█---█-█████-██-████---█-██--█-█-
-█-█---█---█-------█-----█-----------█---█-█-█---------█-----█---█-█-----█-----█-------█---█---█---█-
---█-███-█---█-█-█-█-█-█---█-█-█-█-█-███-█-█-█---█-█-██--█████-███-█---█--██-███-███-███-█-█-█-██-███
---█---█-█-█-█-----█-█-█-█-█-█-█-█-█---█---█---█---------------█-----█-█-------█---█-----█---█---█---
█--███-███--██-█-█-█████---███-█-█-█-█-█-█---█---█████--██-██--█-██---██---█-███-█████-██--█--██-█-██
-----█-█---█---█-█-----█-█---█-█-█-█-█---█-█---█---█-------█-----------█-█-█-----█---------█---█-█-█-
-█-█---█-█-█-███-█████-███-███-█-█-█-█████-███-█-█-█-█-████--██████--██-██-███████-██████████-██-█-█-
---█-█-█-█-█---█---█---------█-----█-----------█-█-█-█-------------█---█-█---------█-█-------█-█-----
-█-███-█-███-█-█-█-███-█-█-███--████-█-█-█-█--████-█-███-█████--██-█--██-█-█-█-█-███-█-███-----███-█-
-█-█---█-█-█-----█---█-█-█-█---------█-█-█-█-----█-█-█-----█-----█---------█-█-█---------█-█-█-█-----
-███-█-███---█████-█-███-█-█-█-█████-██-██-███████-█-███-███-█-███-███-█████████-█-█-█---█-███-█-███-
---█-█-█---------█-█---█-█---█-█---█-----█-█-----█---█-------█---█-█-█-█-█-█---█---█-█-------█-█-----
-███-█-██-██-███-█--██-███-█-█-███-█-███-█-█-█-████-█-██-███-███████-█-█-█-█--█-█-████████████-███-█-
---█---------------█---█-█-█-█-█-█-█---------█-----█---█---█-----█---█-█-----------------█-█---------
-█████-█-█-███--██-█████-█-███---█-█-███-████-█-██-█-███-███-███████-█-█-█-█████-█-█-██-██---█-█████-
---█---█-█-█---█-█-----------█-█-------█-------█-█-█-------█-----█-█-█---█-----█-----█-█---█-█-█---█-
-███████-█-███-█-█-█-█--█--███-█-█-█-█---█-████--███-█-█---█--████-█-█-███-█-██--█-█-█-███-█-███-█-█-
-------█---------█-----█---------█-█---█-----------█-█-█-█-█---█---------█-----█-------█-----█-----█-
--████-████████--████--█-█-█-█-████--█-███████-█-█--████-███████-█████-█---█████-█-██-██-█-███-█--██-
-------█-------█-----█-█-█-█-█-█---█-█-------█-█-█---█-█-----------█-------█-█-█-----█-------█-----█-
-███-█-█-███-███-█████--█--█-█-███-█--██-███-████---██-█-██--█-█---█-█-█---█-█-----███---█-███-█████-
---█-█---█-------█-------█-█---█-█-----█-█-------█-█-------█-█-█-█-█-█-█-█-------------------█-█-█---
████-█-███-████--██--█-█████-███-█-█████-█-███-█-████--█-█-█-█-█-██-██-█-███-██--█-███--██-█---█-█-██
---------█-----------█-█---█---█---█---------█-█---█-█-█-█-█-█-------█---------█-█---█-█-------█-----
-███-█-█-█-███-███-█-█-█-███████-█-██-██-█---█-█████---█-█████-███-█-█-█-██--█-█-██--███-███████--██-
-█-----█-----█-----█-█---█-█---█-█---█---█-█-█-------█-█-----█---█-█-█-█-█-█-█-█---█---█-█---------█-
-█-█-█-█-█████-███-███--██-█-██----█-██--█-█----██████████████-███-█████---█████-███-███-█-████-█-██-
-█-█-█-------█---------------------█-█-----█-█-------------█-----█-█---█-----█---█---------------█---
█--█-█-█-███-█-█-█-█-█-█████-█-█---███-███--█-██-███-█-█-███-█-█████-█-█-█---█-█████-█-█-██--█-███---
-█---█-█-█-----█---█-█---█---█-█-█-█-----------█---█---█-----█-█-█-█-----█-------█---█-█---█-█---█-█-
-█---█-███-█-█-█████-█-█--██-██-██-█--██-█-█-█-█████-█-████--█-█-█-███████-█-█-███████-█-█-██-██---█-
---█-█---█-█-█---█-----█-█-█-█-------█---█-█---------█-----█-----------█---█-----█-█---█-█-█---█-----
--██-█--██--██--████-█████-█----██-█-█-███-█-███----██-███-███-███--██-█████-███-█-███-███---█--██-█-
-----█-█-----------█---█---█-█-█---█-█-█---█---█-█---------█---------█---█---█-------█-------█---█-█-
█---██-█-█-███████-█-█-██--██-██-█-█-███-█-█-██-██-█-█-█-█-███-█---███-█-█-█████-██████--███-█-███-█-
---------█-------█-█-█-----------█-█-█---█-------█-█---█-█---█-█-█-█---█-█-█-----█-----█---█-█-------
-███-█-█-███-█████-███-███-█---█-█-███-█-█-█-███-█-█--██-███-█-█-███-██-█████-██-█-█████-█████-██-███
-█---█-█-█-----█-----█-█---█---█-█-----█-█-█---█-█-----█-█-█-█-█---█---█-█-----█-------█-----█-------
████-███-█-███-█-█-██--███-█-██-████---█-█-█-█████-██--█-█-█-█-█-██--█-█-███-█-█-█-█-█████-███-█-███-
-------█-----█-█-█---█-----█---------█---█-----█-----█-█-------█-█-█-█-----------█-█---█-█---█-█-█---
████-█-█-█--██-███████████-█-█-██----██--███-█-█████-█-█-█-███-█-█-█---█-███-█-█-███-█---█████-██--█-
-----█---█-█-----█-----█---█-------█-------█-------█-█-------█-█---█-█-█-----█-█-----█-----------█---
██-██-████---█-█-█-███-█████-█-███-█████--██---█-██-██-███-█-█████-█-███-█---█-█-██--███-█████-█████-
-----------█-----█---█---█---█-█-----█-----█-------------█-█---█-----█---█-█-█-█-█-----█-----█---█---
███----███-█-█---█-███-█-█-██--█-███-█-█-█-████-██-█-███████--████-█-███---█-█-█████---█████-██---██-
-----█-----█-█-█-------█-------█-█-----█-█-----█-█-█-------█-----█-█-█-----█-█-----█-----------█---█-
████-█-█-██-██-█-███████-███-███-███-███--████-█-█-█-█--██-███-█-███-██---██████-███---█-█-█-█-███-██
-----█-█-----█-█-----------------█-----█---------------------█-----█---█-----█---█-----█-----█---█---
██-███-█-█---███-█████-█-█-█-█-█-----███---█████-█-█-█-█-███-███-█-█████-███-█-----█-█-█████-█-█████-
---------█-█-█-----█---█-█---█-█-----█-----------█---------█-█-----█---█-----█-----█-█---█-█-█-█-█---
-███-█-█-█-██--█-█-███-███-█████-█-█-█████-█-██-██-█-███-█████████████---████--█-█████-██--██-██-███-
-█-----█-█---█-█---█-█---█-----█---█-█-█-----█-----█---█-------------█-------------█-----------------
-█████-█████████-█-█---████████--█-███-███-███-███████-██-█--█-███-█-█-█-███-███-███---███-█-█-█-█-██
---------█-------█-█---█-----█-█-█-█-----------█-----█-----█-------█-█-█-----█---█-------█---█-█-█---
--█--█-█████-█████-█-█---█-█-█-█████-█████-█████-████████---████-██████--█-█-█████-█---██--█████-███-
-----█-█---█-█-----█-█---█-█-----█-----█-----------█-----█-----█---------█-█-----█-█-█---█---------█-
-█-██--█-███-███-███-█-█--███--███-█████-█-█-███---█-█-█-█████-██--██████-██-█-█████-█-█-█████-█-█-██
-█-█-------█-------█-█-█-----█-█---------█-------█---█-█-----█-------█-█-----█---------█-----█-█-█---
-█-█-█-█-███████-█-███-█-███-███-█--███-██--██-█-█-████████████--█-███-███-█-███---█--██---███-███-█-
-█---█-█---█-----------█-------█-█-█-█-----█---█-█-------█-█-█-█---------█-█---█-█-█---█-█-----█--G█-
-█-█-█-█-█-█-███-█-███-█--███-██████-███-█-█--██-███-█-██--█-█-█-█-███████-█-█████-█████-████--███-█-
-█-█-█---█-█-█---█-█---█---█---------█---------█---█-█---------█-█---█---█---█---█---█-----█-----█-█-
-█████-█████-█---████----█-█-█████████-█---█████-██--█-███-███-████--█-█-█-█-█---█-█-█-█-███-███████-
-----█-----█---█-█-----█-█-------█-█-█-█-█---█-----█-█---█---█---------█-█-----█-█---█-█-█---------█-
---███-██--█-█████████-█-█--██-███-█--██-█--█████-██-█-███-███-█-███-█--██-███-███-█-█-█-█-█-███-███-
-█---█---█-----█-------█-█-------█---█---█---------█-█---█---█-█---█-----█---█---█-█-█-█-------█-█---
-█-███-█-███-███-█-█-██-██-██-██-█-█--████-█--██---█-██--█-███-█-█---█-█████-█-███████████-█-█-███-█-
-█-----█-█---█---█-█---------█-----█-----█-█-█---█-----█---█-------█-█---█---█---------█---█---█---█-
92 98