A--------█---------█-█-█---█-------█---█-█-█-------------------█-█-----------█-----------█-█-█---█---
-█-█-█-███-████████----█-█-█-█--████-███-█-█-██----█████--█████--████--█-█████-████-████---█-██--█--█
---█-█---█---------█---█-------█-█---█-------█-------█-----█---█-█-█-█---█-█-█-----█---█-█-█---------
-█--████---███-██-██-███-█████-█-█-███-█████-████████-██████-█---█---█-█-█-█-█-█████-█-█-█-█-█-███-█-
-------█---█-----█-------█-----█-█---█-----█---█-█-█---█-█-█-█-----█---█-----█-------------------█-█-
-███████--██-█-███-██-██-█--████-█-█-███-█----██-█-█-███-█---█---███-███-█-█-█-█---█-██--█-█-█████---
-----█-█-█---█---█---█---█-------------█-█-█-█---█---█-█---------------█-█-█---█-█-█-█---█-█-----█---
---█-█-██--███-█---█-█-█-█-█████-███-█-█-█-█-█-██--███-████---██-█████-█-█-█-█-█-█████████-███-█████-
-------------------█-█-----------█-----█-------█-------█---█-█-█-█-█-█-█-----------------█---█-----█-
-███-█-█-███-█-█---█-█-█--██-█████--██-█-█-█---█-███-███-███-█-███-█-█-█-██████-██-█-█--██████--█----
-█-----█---█-█-█-------------█---█-----█-█-█-----█-█-█-█---█-█-█---█-█-█---------█---█---█---█-----█-
-█-█████-█-----█---███-██----█---█-█-███---█-███---███-█-██--█---███-█-█-█-███████████████-██--██████
-█-----█-█-█-█-█-█---█-------------█-█---------█---█-------█-----------█-----█-----█---█-----█---█---
-█-█-█-███---█-███-███████████-███-███-█-█-███-█-█████-█████-████████--█-█████████-█-██--███-█-██--██
---█-█-█-----█-█-------------█---█-█-█---█-█-█-█-----█---█-█---------------█---------█-█---█-█-------
-█---█-█████-█-█-█--█--█-█-██--█--█--█-█████-█-█--██--██---█-█-███-███-██--█-█-██-███--█-█--████-█-█-
-█-█-█-█-█-----█-█-----█-█---█-------█-----█-█---█---█-------█-█-----█---█---------------------█-█-█-
-█-█-█-█-█-█-███-█-██--███-█-█-█-██--█-█--██-███-█-███-█-█-█--██████-█-█-█-█-█████-█-█-███--████-████
-█-█-----█-█-----█-------█---█-█-█-█---█-----------------█-----█-------█-█-█-------------█---------█-
-█-███-█-█-██--███████-███-████--█-█---███-█-███████-█--██-███-███-█-██-██████-█-█-███████-█-█--██-█-
-█-----█-█---█-█---█-----█---█---█---█-----█-█-█---█-█---█---------█---█-----█-█-█---█-█-█-█-█-█-█-█-
██-███-███-███---███-█-█-█-███-█-█----██████-█-█-█-███-█-██--███-█-█-███--██████-███-█-----█████-███-
---█---█-----█---█-----█-█-----█-█-----------------█---█-█-█---█-█-█---------█-█---█-█---------------
-█-███-█████-█-█---█----███████----██----█-█-███-█-█-█--██-█-██--█-█-█-███--██-█-███-█-████████--██--
-█-----------█-----█-█---█-█-█-█---█---█-█-█-█-█---█-----------█-█-█-----█-------█---------------█---
██-█-█--█-██-█-█-███-█████---█-█-████--███-███-███--████-█-█-█-███-█---██-██-███-█-██████-██████-█-█-
---█-█-----█-█-█---█---------------█---------------█---█---█-█-█-----█-----█---------█-█-█-█---█-█---
-█-█-█████-███-██-█--█-████-██-███-█-███-██-██--██-█-█-█--██--█████-████-███-█-███-█-█-█-█---███-█-██
---█---------█-----█-█---------█---█-----█---█-█-----█-█-█-█-----█---█-█---█-█-------█-█-█-------█-█-
██---█-█-█-██-████████-█-█-██-████-█████---███-██--█---█---█-█-█-███-█-----█-██--█████-█-█--█-██-█-█-
---█---█---------█-------█-------█-█-█-█-----------█-█-█-█---█-█---------------------█-█-█-----█-█---
-█-█--██-███-█---██---████-█----████-█-█-█████-█████-█-█-█████-█-███-█-█-█-█--██-█████-█-█---█-█-█-██
-█-█---█---█-█-█-█-----█-█-█-----█-----█-------------█-█-------█-█-----█-█---------█-█---------------
---█-█-█-█-█-███-█████-█-█-███-█-███-█-█-█-█████-█--████-███-███████--██---█-███████-█-█-█-█-█-█████-
-█-█-█---█-----█-----█-█-----█-----█-█---█-----------------█-------█-█---█-█-------█-█-█-----█-----█-
██-██-█--█-█-█████████---███------████-█-███-█---███--██-█████████---███-███-█-█-███-█-█-█---█-█-████
---█-----█-█-------█---█---█-█-█-----█-█---------█-█---█-----█---█-█-█-█---█-█-------------█---█-----
██-█-█-█---█-█-███████-█---█████-█-███-█-█-███-███-██-██-█████-█-█-███-█-███-█-█-█---█████-███-███-█-
-█---█---█-█-█---------█-█-----█-█-█---█-█---█-----------------█-█-----█-█-----█-█-█-----█---█---█-█-
-█-███-███---███-█-█-█-█████--██-█-████--███-███-█---██████-███--███-███--█████--█-█-█████-██--█-█-██
---█-----█-█---█-█---█-----█-█-------█---------█-█-----------------█---█---------█-█---------█-█-█---
--███--█-█-█--████-█-█-█-█-█-█-█-█--██-█-███-█--█--█-█-█--██-█-█-███████-████--█-█-█-█-███-███-█-████
---█-----█---------█-█-█-█-█-█-█-█-█---█---█-----█-█-█-█-█---█-█---------------█-█-█-█---█-----█---█-
-█-█-█-██-██-█-█████-█-█-███-█-████--███-█-█-█-███-█-███---█████---██----█-█-█-█████-█-█-█-███-█-███-
-----█-------█---█-------█-----█---------█-█-█---█-█-█---------█-------█-█-█-█-------█-█-----█-█---█-
-█-█-███-█-███--███--█-█████-███████---█---█-██--█-█-█-███-█-███-█-██--█████-█-███-█-█████-█-███████-
-█-------█---█-█-----█-----█-----█---█-█-█-█---█-------█-------█-█-█---█-----█-█-█-------------------
██-█--████--█--█--██-██-████-█-███-███-█-█--████---█-█-█-█-█████-----██--███████-█-█-█-█-███-█-█-████
---█-----█-█---------------█---█---█---█-█---█---█-█-█---█-█-█---█-----------█-█---█-█-█---█---█-█---
██-█------████-█-█-█████-███-█-█-█-██████---██-█---█-█-█--██-██--█-█---███-███-█-███-█-█-█-█-█-█---██
-█-█-█-----█---█-█-----█-█-----█---█---------█-█---█-█-------█---█---█---------█-█-----█---█-█-------
-█-█-█████████-█████-█-███-███-███-██-██-██-██-███-█-█-█---█-█-███-█████-███-█-█-███-█-███-█-███-█-█-
---█-----█-----█-----█-----█-------█---------█-----█-█-█-█-█-█-█---------█-█-█-----█---█---█---█-█-█-
██-█-█--██████-█-█-██--███--██-█████-█---█-███----█-██-█-█-█████-█---██--█-█-█-█████-█-█-█-█--███████
---█-█-----█-----█---█---------█-----█-█-------------█---█---█---█-----█-█---------█-█-█-█-█---------
█--███--██-███-█-█-█-█-█████-█-█-█████-█---█████-███████-█-███-███-----█████---███████-█-█-█---█-█-██
---█-------█---█-█-█-------█-█-█-█-----█-█-------█-------█-█---█-------█-█---█-█-------█-█-------█---
██-███-█--██-█-█-███-█████-█████----██-█-██--█-███-███-█-█-██████--█-█-█-█-███-█--██-█-███-█-█-█-███-
---█-----█---█-----█---█-------█-█-█---█-----█-------█---------█-----█---█-█-█-----------█-█-█-█---█-
-█-█-███-█████-█---█-█-███-███-███---█-█-█-█-███-█████--████-███████-███-███-█-███-████--█---████████
-------█-█-------█-█-█-----█-----█-------█-█-█-----█-------------█---█-----█-----█-█-----█-----------
██-█-███████-█-█-█-█-███-███-█-███-█████-█-█-█-█████-█-█-█---█-█-█--█-██-█████-█---███-█---█████-███-
---█---█-----█-█-----█---█---█---█-█-----█-█-------█-█-█-------█-------█-█-----█-█-█---█-█-█---------
----████-█-█████-█-█-█-█-█--██-███-█████-█-█--██████-███-█-█-██-█-█-████--██-█-█-█---█████-████--█-█-
-----█---█-█-----█---█-------█---█-█-█---█-█-------█---█---------------------█-----------█-------█---
-██--█████-███-█-█-███-█-█████-███-█-█-███-███---████--█---█-███-███-█-███-█-█-█████--██████-███-████
---█---█---█---█-----█-█---█-----█-█---█-█---█-█---█---█-█-----█---------█-----█---█-----------█-----
-███-█████████---█-███---█████████-█-----█-█-█████-█--████---███████-█████-███-██--█-█-█-█-███-█-█-██
---█-█---------█-█-█---█-█-█---█-----█-----------█-█-█-------█---█-----█-----█-█-----█---█-█---█-█---
-███-█████-█████-█-█████-█-------█-█-█-███---█-█-███-███--██-█---█-█-███-█████-█--██-█-██-██-█████-█-
---█-█-----█-----█---------█-█---█-█-█-----█---█---------------█-█-█---█---█-█-█---█-█---------█---█-
████-█--██-█████-█-█-██-██-█-█-█-█████-██--█-██-██-█-█-█-█-█-█-█-█-█-█████-█---█--██-█-█-██-██-█---█-
-----█-------█-█-█-█-█---█---█-█-█-------█-█-█-█-█-█-█-█-█-█-█-█---█-----█---█-----█-█-█-----█-█---█-
-███-███-█-███-█-███---████----███████---█████-█-█-█████-█-█████-█-█████-█-███-█-█████-█---███████-█-
---█-█-------------█-------█-█-█-----█-█-----------█-----█---█-█-█---█---█---█-█---█-█-█-----------█-
██-█--███████----███-███-████-██████-█-█-█-█-█-███-█████-█-███-█---█████-███-█-█-███-█-███--████-██--
---------█-----█-█---------█---█-█-----█-█-█-█---█-------------█---█-------█-█-█---------█-█---█-█-█-
-█-█--██-█--██---█-█-█████████-█-█-█-█-█-███-█-█-█-███-█-███---█--██-████████-██-█-█-█-███-█-█-█-█-█-
-█-█-█-----------█-█-------█-------█-█---█---█-█-----█-█-█---█-------█-----█-█-█-█-█-█-█-█---█-█-----
-██-██-██--███-█-█-█-███-█-███-█-█-████--█---█████-██-██-█--██-█-█-█-█-----█-█--████-███-█--██-█-████
-█-------█-█---█-█-----█-█-----█-█-█-█-----█-----█-----█-----█-█---█-█-█---█-----█-------█-----------
-█-█---█-███-█-█-█-█---██-██---███-█---█-█---█-█-█-█-██--█-█---███-███---█-███-███-█-████----█-█-███-
-█-----█-█---█---█-█-█---█-------█---█-█-█-█-█---█-█-█---█-█---█---------█-----█---█-------█-█-------
-██--███-█-█-███-█---█-█-█-█-█-███-█---█-█--████---█-█-█-███--███--███-█-█-██--█--████████-█-█-█-█--█
---█---█-█-█---█-█-█-█-█-----█-█---█-█-█-█---█-█-█-█-█-█---█-█---------█---------█---------█-----█---
-██--█-█-███-█---███-███████-███-█-██--█-█-███---█--██-█-█-███-███-----█████----█--███-███---█-█-█-██
---█-█-█-----█-█---█-----█-----█-------█-█---█---█-█-----█-----█-█-█-█-█-----------█-----------█-█---
-████-██████-█-████--█-█-█-█-█-█-█-██-██--████-███-███-█-█-█-███--█-██--█--█-█-█-███-███-██--██-██-█-
---------█-----------█-█-█-█-█-█-------------█---█-█---█-█-█---------█---█---█-█-------█-█-----█---█-
-███-█-███████-████-██-███-█-█-██-███-██-█-█-█-█████-█-█--██-███---████--█████---█-█---████---████-█-
-----█-█-------█---------█-█-█-█---------█-█-█-------█---------█-------------█---█------G█-----------
██-███-███---█-██--█-█-████---█-█--██-██-█-█-█████████████-█-█-█-█-█-█--████-█--██████---██--█-█████-
-----█-█---------█-█-█---------█---█-----█-█-█-█-------█---█-█-█---█-----█-█---█-----█---█---█---█---
██-███-█-█-█--████-█-█-█-███-█-███-█-███-█-█-█-█-███-███████-█-█-█-█---███-██-██████-████████--███-██
---------█-█---------█-█-█---█---█-----█-█-█-------█-------█-█-█---█-█-------█---█---------█-█-█-----
--█-██-███████-█-███-█-███-█-█-███-███-█-█████-█---███-███--██-███--████-█████-███-█████-███-███-██--
-------█---------█---█-----█-█---█-█-------█---------█-------█---█-----█---------------█-----█-----█-
████-█-█-█████-███-█-█-█-█████-███-█████-█-█████-███-████--█████-█-█-█--████-███-█████-███████-█-███-
-----█-█---█-----█-█-█-█-█-█-----█---█-------█-----█-----█---█---█---█---------█---█-█-█-----------█-
-█-----███████-█-█-███-███---█-███-█---█-█-█-█-█-███-█-█-███-███-█-█-██--███-███---█-█-█-█-█-█-█-█-█-
---█---█-----------█---█-----█---█-█-█-█-█-█-█-█---█-█-----█-█---█---█---------█-█-------█-█-█-█-█---
90 88