A--------------█-----█-█-----█-█-------█-----█-█-----█-█-█---█-█---█-----█-█---█-----█-----█---█-█---
██-█-█--██--██-███-███-█-█-███-█-███████-█████-█-█████-█-█-███-█--█--████--█-███-█-█-█---█---███-█-██
-----█---█---█-█-█-█-█---█-█-█-█---█-█-----█-------█-█-█-█---------█-█-█---█-------------█---------█-
████-██--██████--█-█-█-██-██-█-█-█-█-█-████--█---███-█-█---█-███-███-█-█---█-█-███----████████-█-███-
-------█---------█---█-------------------█-█-█-█---█-█-------------------█---█---█---------█-█-------
██-█-█-██-██-█--██--█---██-████-██████████-█-█-█-█-█-█-██-████-███--██-█-███████-██--█████-█-█---███-
---█-█-----█-------------█---------█-█-------█---█---█-------█-------█-█---█-----█-█-----█-------█---
██---█-███-█-█-█-█-█-█-█-████--█████----█-█--█-████--█-███████-█-█-█-█-█████-█-█-█-█-█-███████-█████-
---█-█---█---█-█-█-█-█---█-█-█-----█-------█---------█---█---------█-█-█-------------█-█---█-█-----█-
-█-███-█-█-███-█-█-█----██---████-█-----██--██████-███--██---███-█-█-█-█-███-█-█-█████-█-███-█████-█-
-█---█-------█-█---█-█-----█---------█-█-█-█---█-█-█-------█---█-█-█-----█---█-█---------------█-----
-█-█-█-███-██-█--█-█-█-███-█-███-█--████-███-███-█-█-███████-███████---██████-████-█████--████---██-█
---█-█---█---█---█-█-█---█---█---------------█---█-----█---█-█---█-------█---█-----█---------█-█-█---
-███-█-█-█-█-█-███--███-███--█-███-█████████-███---█████-███-███-█---██-██--██-█████-████-█--█-█-█---
-█---█---█-█-█-----------█-----█-------█-█---█---█---█---█-█-------█-----█-█---█---█-█---------------
-█-█-█--████--████-█-█-█-███-███-█---███-█-█████-█-███-███-█-███-█-█████-█---███-███-███-█████-███-█-
-█-█-█-█-█-------█---█-█---------█-------█-█-█-----------------█-█---█-█---█-█-----------█-------█-█-
-█-█-█-█-█-█-███-██--█-████--█-█-█--██-█---█-█-█-█-██--███-██--███-███-█████-█---█-███-███-█████----█
---█-█---█-█-█-----█-█-----█-█-█-█---█-█---------█-------█---█-█-█-----█-------█-█---█-----█-█-------
----████-█████-█████████████-█-███-███-█████-███-█---███-██--█---█-███-█-███-█--███-██-███-█---█---██
-█---█---█---------█-█-------█---█-------█-█---█-█-█---█---█-------█-------█-█-█-------█-█---█-█-█---
-█-███--██-███-███-█-███--█-██--██-█-█-███-███████-█████-█---█---███-███-█-████-██-----█-████--███-█-
---█-----█-█-----█---█-------█---█-█---------█---█---█---█-█-█-█-----█-█-█---█-----█-------------█-█-
██-███--██-███-█-█-█-█-█-█-███-███-███-█-█-█-█---█-██--█████-█-███---█-██████--███---█-█-███-█-█-█---
---█-------█---█-█---█-█-█-█-█-█-----█-█-█-█---█-█---------█-█---█-█-----------------█-█-█-█-█-█-█---
-██--█-███-------███-█-----█--██-█-██████-██-█-█--██████-█-███-██-██-█-█-███---███-███-█---██-██--██-
-█---█---█-█-█-█-█---█-█-█-█---█-█-█-█-------█-█-----█---█-█-█-----█---█---█-█-█-█---█---------█-█---
-█-█-█-███--██-███-█-███-██--███-----█████---█-█---█---█████-███-█-█---███-██-██-█-█-█--██-█████---██
-█-█-█-█---█-------█-█---------█-█---------█-█-█-█-----█-█-----█-█-█-------------█---█---█-----------
██████████-███-█-███████---█-█-█---█-█-██--█-█-█-█-█-█-█---█-█-███--████-███████-███-███-█-█-█---█---
-----█-█-----█---█-------█-----█---█-█-------█---█-█-█-----------------█-----------█---█---█-█-█-█-█-
██-█-█-███--█-████-█--█--█-█-█-█-█-█-█-█-███-█-█-█-█-█-█-█-███████-█-██--███--█-████-█---███-█-█-█-█-
---█-█-------█-█---█-----█-----█-█-█-█-----█---█---█-█---█---█---------█---█-------█-█-█-----█-█-█-█-
██-█--██-█-███-█-███-█-███-█--█--██-███--█-███--█----█--██████-██--███████---█████-█-█-██----███-█-██
-----█-------------█-----█-█-█-----█---█-█-----█-------█---------█-█-█-█-█-------█-█-█---█-█---------
████-███-███-█-█████████--██████-███-█████-███-███-████--███-█-█-██--█-█-██████--███-███████-██-██-█-
---------█---█---------█-----------█-----█-█---█-----------█-█---------------------█---------█-█---█-
-█-███-█-█-█-███-█-█-█-█████-█-█-███---█-█-█████████-█-█-███-████-████-█-████--██--██████-███----████
-█-█-----█---------█-█-----█-█-------█-█-█---------█-█-█-------------█-█---█-----█-----------█-█-█---
██-█████-█---█████-█-██-██-███-███-█-████--█-█████--██-█-█-█-█---█--███-█--███-█-███-█--██████---█-██
-█-█-----█-█---█-█-------█-█---------█---█-█-█---█-------█-█---█---------█-█---█---------------------
-██-█--█-███-███-████-██-█-----█-█--█--██--█-█----██-█-███-███-█-███-███-█-█-█-████--███████████-███-
-------█-█---------------█---█---█-------█---█-█---█-█-█-█---█-█-█-------█-█-█-----------------█---█-
██-███-█-███-█-█-███-███████-█-█-█-█-███████---████--█-█-█████-█-█-█-███-█-█-█---█-██----██--█-█-████
---█---█---█---█---█-█-----█-█-█-█-█-----█-█-----█-----------█-█-█-----█---█-█-█---------------█-----
██████-█-███-█-█-███-███-████--███-███-█---███-██--███---███--██████---█-█-█--██-█████-███████████-█-
-------█---█-█-█-------------█---█-█-█-------█---█-█---█-█-----------█-█-----█-------█---█-----█-----
-█---█-█-█-██---████-█-█-█████-█-█-█-███-█-█-█████-█████-█-█-█-█████████----██-█-█-█--████-█-█--██--█
-█-█-█---█-█-█-----█-----------█-█-----█-█-------█---█---█---█-----█---█-----█-█---█-------█---█-----
██████-█-███-█-███-███-███████---███-███████-█████-███-███-█████---█-██--███-███-█-█-█-███-███-█-███-
---█-----------█-----█-----█-------█---█-█-----█-----█-------█---------█---█-----█---█-█-------------
█--█-███-███-██--█-███-█-█████-█-█-█-█---█-█-█████-█████-███-███---█-██--██-████-███-█--██-███---███-
-------------█-█-█-█---█---█---█-█-█-█---█-----█-----------█---█-█-█---█---█-------█-█---█-----█-█---
-██-████-█-███-████-██-█-█-█-█---███-███████████-█--██-█--███--█-█-██--█-██████-██-███-███--██--██-█-
-█---------------█-----█-█-█-█-█---------------█-█---█-█-----█-█-----█---█-------█-█---------█-----█-
-█-█-█-█-█████-█-█-███-███-█-███---█-███-███-█-██-█-█---██---█-█████---█-███-█-█████-█---█---█████-█-
-█---█-----------█---█-█-█-█-█-█-█-----█---█-█---█---█-█-█-----------█-█-----█-----█---█-------█---█-
█-████--██--████████-█-█-███-█-█-██--███-███---█---█-█-█-██-██-████--███-███-█-██████---█--███-███-█-
-------█---------█---█-----█-----█-----█-----█---█---------------█-----█-█---------------█-█-█-█---█-
████-█-███---█-█████-█-█-█-███-█-█-█-███-█-█-█-███-█-█-█-█-████--██████-██████████-█-█-█-█-█-█-██--█-
-----█-█-█-█-█-█-----█-█-█-----█---█-█-----------------█-------█-------█---█---█---█-█-█-----█-█-█-█-
████---█-█---█-█-█-███-█-█-█-███-███-███-███-█-███-██--█-█-███-█-█---█████-█-███-██--█-█████---█-█-██
-----█---█-█-█---█-█-█---█-█-█-------█-----█-█-----█---------█-█-█-█---█-------█---█-█---█---█-------
-█-█-█-█-█-███-█████---█-█-███-████--█-███-█████---█--█--███-█-███-█████-█--█-██-███-█████-█-█-███-██
-█-█-█-█-----█-------█---█-----------█---█-------█-----█-----█-█---█---█-------█-█-------█-------█-█-
--█--█-█████-██---█--█-█-█-█-███-███-███-█████-█---█-█-█████-█████---█████-█-███-█--████-█-█-█-█████-
---█-█-----█---█-█---█-█-█-----█---█-█-------█-█---█-█-----█---█-█-----█-█-----█-------█-█-█-█-------
-█████---█-█-███-█-███-███-█-███---███-█-█████████-█-█-█████-█-█-█--████-███-███-█-█████-█-█---████-█
-█-█-----█---█---█---█---█-█---█-█-█---------------█-----█-------█---█---------█-------█---█-█-█-----
-█-█-██████----█-█-█--██-█---█-████---██-███-██----█-█-█---█-██--█-█████-███████-█-███████████-█-█-█-
-----------█-█-█---█-█-█-█-█-█-----█---█-█-█---█---█-█---------------█-----------█-█---------█-█-----
---█-█-████-██-█-█████-█-███-███-███████-█-███---█-██--█-█████████████████---█████-█-██████-██-----██
-█-█-█-----█-----------█---█---█-█-█-------█---------█-█-------------------█---█-█-------------█---█-
-████--████--███-█-█---█-█-███-███-█-█-█-███-█--████-█-███-█████-█████-█-███-██--███-█-█-███████-█---
-----█---█---█-------█-█-█-█-------█-█-█-█---█---█---█---█-----█---█---------------█-█-█-█-----█-█---
-█-███-███-███████--██-█-█-█-█-███-███-█-███-█-█-███-███-█-█████-███████-█--██--█--███████-█████-█-█-
-█-█-----█-----------█-█---------█-█---█-------█---█---█-█-█-------█-----█-█-----█-█---█-----█---█-█-
-██--█-█-█-█--██-███---███-█-----███-█-█--██-███---█-█████-█-█-██--███-█████--███-██-█-█-█-█-█-█-█--█
---█---█-----------█-█-█-----█-█-█---█-█---█---█-█-█-------█---------------█-------█-█-----█---------
-█████-█████████-██--█--██-█-█-█-█-----█████-███-█-█-█-█-███-███████-█-███-█---█████-█-█-███-█---█-█-
---------█-------█---------█-█-█-█-█-----█-------█-----█-█---------█-█-█-█---█-----█-----█-█-█---█-█-
-█-█-█-█-███-█-█-█--██-██-██-█-███-█-█-█-█---███-█-█-█-███-███-███-█-█-█-█-█-█-█-█-███--█----█-██████
-█---█---█-------█-█-------█-█-█---█-█-█-█-█---█-█-█-█-█---------█---█---█-█-█---█---------------█-█-
-█-███-█--████-█-███--█--█-█--█--█-█-█---██--█-███-█-█-█-█-███-█-█-█-███-█-███-█-█-███████-█-█████-█-
-█-------█-----█-------█-------█-█-█-█---█---█-----█-█-█-█-█-█-█-█---█-------█-█---------█-█---------
███---██-███-███-█-███--████-█████-██--█-█-█--██████-█-█-█-█-██--█████-█-█-█---█-█--██--██-█-█-█-████
-------█-█---█---█---█-----█-█---█-█---█-█-█-----█---█---------█-----█-█-█-█-█-█-█---█---█-█-█-█--G--
-█---█-█-█-█████-█-█-█-████--█--██-█████---█-██--█-█-█-███-█-█████-███-█-███-█-█---███-█-█-█--██-█-██
---█-█-█-----█---█-█-----█-█-█---█---█---█-█-----█-█---█---█-█---█---█---█---█-█---------█-█-█-------
-█-█-███-█-███---█-█-█-███-██--███-█-███-███-███-█--██---█-███-█████--██-███-█-██--██--█-█--████-██--
-----█---█---█---█-█-█-----------█-█-█-----█---█-█-█---█-------█---█---█---█---█---█-----█-----------
-█████-█████-███-█-███-█████████-█-█-█-█--██-█-█-███-█-█████-█-█-█-█-█-█-█-███-███-███-█-█--█--█-████
-------------█---█---------█---█-█-█---█-█---█-█-----█-█-----█-----█---█-█-█-█-█---█---█-█---█-------
-███-█-█-██--█-█-█-██--█-███-█-███-█-███--██-█-█-█-█-█-███-█-█████-█-███---█-██--███-█-███-█-█-█-████
-----█-█---█-------█-------------█-█-█-█---█-█-█-█-█---█-------█---█-----█---------█-█---█-█-█-------
-███-█-█-█-█-█-████-██---███-███-███-█-█-████-██--██████--██-█---███████-███-█-█-███-█-███-██----█-█-
-█---█---█-█---█-------█---█-█-█-----█-█-----------█-----------------------█-█-█---█-█---█---█---█-█-
█--█-█-███████-███--██-█-███-█-███-█-█-█---█-██---█-████████-█-█-███-█-█-█-███-█-███--███--█-█-███-█-
-----------█-----------█---█---█---█-█---█-█---█-█---█---█---█-█-----█-█---█-█-----------█-█-█---█-█-
-█-█---█-█--██-█-█-█████---███-███-█-█-█-█████-█-██--███-█-█-████-██████-█---█---█████-█-█████████-██
---█-█-█-------█-█-----█---█-----█-----█-------█-█---------█-------------█-█-----------█---------█---
86 98