A█-█-█-█-█---█-█-------█---█---------█-█---█-█-█---█---------█-----------------------█---█-█-----█-█-
-█-█-█-█-----█-█-███-█-█---█-██-██-███-█-█-█-█-█-███-██████--█-█--██-███-███---█--████-█-█-█-█████-█-
-------█-█-----------█-----█-█-----------█---------------------█---█-█-█-█---█-█-█-----█-------█-----
-█-█-█-█-█-███-███---█-█-█-█-█-█████---█-█-█████-█-███████--██████-█---█-███-█-███-██--███-████--███-
-█-█---------█---█-█-----------█---█-█-█---------█---█-█---------█-----█---█-█-------█---------█---█-
-███-█-█-█-█-█-█-███-█-███-█-█-█-███████-█-███-███████-█---███-█████-█-█-███-█-█-█-█--██-█-███-█---██
-------█-█-█-█-█---█-█-----█-█---------------█-█---------█---█---█-----█-█-█-█-█-█-------█---█-------
-███-█-███-█-█-█-███-███-█-███-█-█-███-███-█--██-█████-█-█-----█-███-█--█--█---███-██--█-█-███-█-----
-█-------█---█-█---█---█-█-█---█-█---█---█-------█-----█-█-█-█-----█---------█---█-----█-█-------█-█-
-█-██--█-███-███-████----█-█-█-█████████████-█-███-███████-█---█-█-███-███-█████████-██----███-█-█-█-
-█-█---█-█---█-█---█---█-█-█-█---█---█-----█-------------█-------█-█-█---█---------█---█-█---█-█---█-
-████--█-███-█-█--████-█-███-███-█-█-█--█--███-████--███-███-███████-█-███-█-███████-█-█-█---█████-██
-------█-█-----█-█-----█-------█-█-----█---------█-█---█-█-█---█---█-█---█-█-█---█---█-█-----█-------
--██--█-████-█---███-██--█████████---███-███-█-█-█-████-██-███-█-█-----███████-█-███-█-█-█-█---█-████
---█---------█-█-█-█-█-------█---------------█-█-█-█-█-█---█-█---█-------------█---█---█---█-------█-
████-███-█-█-█-██--███-███-█████-███---█-██-█████--█-█-███---█-██--█████████--████-█████---████████--
-------█---█-█-█-----█-------------█-█-█---█-----█-█---█-█-█-----█---------█---------█---█---█-█-----
-███-█-█-█-█████-█-█-█-███-█-█-█--███--█-█████-█-█---███-█-█-█-█-███████--██-███████-█--██-█---█-█-██
-----█---█-------█-█-█-----█---█-----█-█---------------------------█-█---------█-----█-█-█-------█---
-█-█-██-██-███---███████-█---██--█████-█-█--█--██--█-█-██-█████-████-█-█████-█-█-█-███---█████-█-█--█
-█-█-----█---█-█-----------█-------█-----█---█---█-█-█-------------------█-█-------█---------█-------
-███-█-████--█-█---█-█-█-█-█-█-█-█--██-█-███---█-███-██--█-███-███-███-█---██--█-█-█-█-███-████--████
-█-█-█-----█-█---█-█-█-█-----█-█-█---█-█---█---█---█-█-------█---█-█---█-█---█-█-█-█-----█-█---█-----
██-█-█-██████-██-█-█-████-██-█████-█-█---█-█-███-███-███-█-███-█-█-█-█-█-█-█-█████---█-█-██--████-███
-----█-------------█---█---------█-█-█-█-█-█---█---█---█-----█-█---█---█---█-----█---█-█-█-----------
███-██-█████-█████-█-█-█-██-██-█--██-███--██████-█████-█-█-██-████-█████-█-█████-█-███-███-█-█-█-████
-----------------█-█-█-█---█-------█-█---------█-█-█---█-█-------█-------█-----█-█---█-----█-█-█-----
██---█-█████-█-███████-█-███-█-███-███-█-███-█-█-█-███-█--██-███-█-█-█-█-█████-██-█----█-███-█████-█-
-█-█-█-----█-█-------█-----█-█---------------█-█-------█-█-----█-█-█---█---------█---█-----█-----█-█-
-███-█-█-█-█-████--█-███-█-█-█████-█--██--█-████-████-█████--█-███-█-█--██----██-█-█---██-██████-█-█-
-----█---█-█-----█-█---█---█-----█-----█---█---█-------------█---█-█-█---█-------█-█---------█-------
-█-█-█-██-██-███-██-██-█-█-█-█--██---███-█-█-███-█-█-███-███-███-█████-█████-██--███████-█████-███-█-
-█-█-█-█-----------█-█-█-█-█-█-█---█-█-█-█-------█-█-----█---█-----█-█-------------█-█-█---------█-█-
████-█-████--█-███-█-███-███-██--███-█-██--█-███-█--██████---█---██--█-███-█-█-█-███-█-█-█-███-██████
-█---█-█-----█-█---------------------█-█---█---█-█---█-------█-█-█-----█-█---█-█-------█-█---------█-
-███-█-██--███-█-█████████--██-████--█-█-███--█-██████-██--█-███-█-█-█-█-███████-███████-███-███-███-
-----█---█---█-█---------█---█-------█-█-█-█-█-█-█-------█-█-------█-█-----█---------█-█-█---█-------
-█-█-█-███-█-███-█-█-█-███-█-█-███████-██--███-█-█-███-███████-█-█-█████---█-█-██-██-█-███--████-█-█-
-█---█-█---█-█---█-█-█-------█-------------------------█-------█-█-----█-█---------------█-----█-█-█-
-█████-███-█████-█-█-███-█---█-█████-█-███---██--█-█---█-█████--████-███-███-███-█-███████-██-██---██
---█---█-------█-█-█---█-█-█-█-------------█-█-█-█-█-█---█-█-----█-----█---█-----█---█-█-------█-█---
-█-█---█-███-███-███-█--████--█--█--██--█-██-█-█-██----██--███-██████---██-█████-████--█-███████████-
---█-█-----█-█-█---█-█-----------█-█-█---█-█-------█-█---█-█-█-█-█---█-█-----█-----------█-----█---█-
-█-█-█-█-█-█-█-█--██-█████-█-█-██--█-███-█-█-█████-███-█-█---█---█-██-████-█-█████████-█--██---█-████
-----█---█---█---█-█-----█---█---█-----█-█-------█---█-█-------█---█-█---█-█-------█---------█-█---█-
-████--██--█-█---█-█-█-█-█--████-█-█-█████-█████-----██-████████-----█-█████----██-█-█-█-█-████--█---
---------█-█---█---█-█-------█-----------------█-█-█-█-----------█-█-█-----█-█---█---█-█-█---█-------
-█████-███-█-█---█-█---███--████-█████-███---█--██-█-█-████--█-███-█-█-█████████-███-█-█-█---█-█-█-█-
-█-█---█---█-█-█-█-----------█-------█---█-█-█-----█---█-----█-█---█-----------█---█-█-------------█-
█--███---███---█████-█-█-█-█-█-██--█-█-███-███-█████-███-█-█████-███-█-███---█----████-█-███-████--██
-----------█-█---------█-█-█-█-█-----█---█---█-█-----█---------------█---█-----█---█-█-█-█-------█---
-█████-███████-█-█-███-█---███████---███---█-███████-█---█--██-███-██--█-█-███-█-█---█---███-███████-
---█---------█-█-█-----█---------------█---█-█---█-----█---█---------█-█---█-----█---█---------------
-█---█-████--████-██-███-█--█-█████----█-███-█-█████---█-███-██-██████████-███-----██-██-███-█-█-█-█-
-█---█-----------█-----█-█-------------█---█---█---█-█-----------█---█-----█---█-------█-█-█-█---█-█-
-█-███---█-█-█-█-█████-█-███-█-███-█████--██-█-███-█-█-█████-█████-███-████████████--█-███--████-███-
-█-█-------█-█-█-------█-█-----█-----█---█---█-█-----█---------------------------█-█-█-█-----█-█-█-█-
██--████-███---███-███-█---█████---████--████--█-█-█-█-█-█-██-██--███--█-█---███-█-█--██-███-█-██--█-
-------█---█---█-----█-█-------█-█---█-█-█-----█---█-█-█-█-█-█---█-----█---------------------------█-
-█-█-█-█-█████-█████---███-███-███-███-█-██--███-███-█-█-█-█--███-██-██████--██--███-██-██-█---█-████
-█-█-█-------------█-█-█-----█-█-█-------█---█---█---█-█-█---------█-------█---█-█-█-------█-█-█-----
---█-█-██-██-█-█-███-█--██-█-█-█-█████-█-█████-█-█-███-█--█--█-████-████-███---█-█-█-███-█-█---█-█-█-
---█---█-█---█-----█-█-█-----█---█-█-█-█-----█-█-█---█-█-█---█---------------█-█---█---█-█-█-█-█-█-█-
██-██------███-███-██--█-█-█-███-█-█-█-███-█---█-███-█-█-█-█-█-█-████-███--███-█-██--█-██--███-███-██
---█---█-----█---█---█-█---█---█-█---█---█-█-█-----█---█---█---█---------█-----█---█-█-------█---█-█-
█--█-█-█-█-███--██-█-███-█-█-█████-███-█-█-█-█-███-███---█-███-█-████--█████-█-█-████████-██--█--███-
---█-█-------█---█-----█-█-█-█-█-----█-█-█-█-█-----█---█-█-█-------█-----█-----█-█---█---------█-█---
-█---███-█-█-███-█████---█████-█-█-███--██-█-█---█-█-█-███████-█---███-█-███-█-███-███-███-███-█-█-█-
-█-█-█---█---█---█---------------█-█-----█-----█-█-█-█---█-█---█-█---█---█---█-----------█-█-█-█-----
██-███-█-█-█-█-█-███-█-███-███-█-█-█-███-█-█-███-███████-█-███-███-███-█-█████-█-█-███-████--███--███
---█-----█-█-█-------█---█-----█-█-------█-█-█-----█-----█-------█-█-█-█-------█-█---█-█---█---█-█-█-
-███---███-█-█-█████████-█-█-██--███-█-█-██████-█████--█---█-█████-█-█--██-███-█████-███---█-███-█-█-
---█-█-█---█-█-█---█-----█-█---█---█-█-█-█---------█-█-█-█-█-----█-█-----█-█-------█---█-█-------█---
-█-█--██-█-█-█████-███--██--███-██-███████-█-█-██-█----█-█-███-██-██-█-█-███-███-█-█--██-███-█-█-█-██
-█-█---█-█---█---█-----█-█-------------█-----█---------█-█---█-----█-█-█---█-----█---------------█---
-███-█-█--████-█████-███-█-█-█-████---█--█-████-██-█--██-████--█████-███████████-█-███-█████-█-█-█-█-
-----------█-█-------█-----█-█-----█-----█-------█---█-------█---█-------------█-----█-----█-█-█---█-
-█----████-█-█-████-█-██-█-█-███-█-███-███-███-███-█-███---█-█-█-█-█-█-█--█--███-███-█████████-█████-
-█-█-----█-█-----█-------█-------█-------█---█---█-█-█-█-█---█-█---█-█---------█-█-----------█-█-----
██-█-███-█████-█---█-█████---█-████-████████████████-█-███-█---█-███-████--█--██-█---█-███████-███---
---█-█-----█-----█-█-█-------█---------------█---------█---█---█-█-------█-----█---█-█-------█-----█-
█----███-███-█████-█-███-█████-█-██--█-███-██--███---█-█--██-██-████----██-█-███-███-█████-███--████-
---█-----█-█-█-----█-█---█---------█-█-█-------█---█-█-----█-----█---█-█---█---█-█-------█---------█-
██-███████-█-█-███-███-█-███-█-████--█-█-█-███-█-█████---█████--██-███-███---███████-█-███-█---███-█-
-------█-----█-█-█-█---█-------█-█---█---█---█-█---█---█---█-----█---█-█---█---█-----█---█---█---█G█-
-█-███-███-█--██--██-███-█████-█-█-█-█████-█--███-████-█████---███████████-█-█████-█-█-█████-██-██--█
-█-█-----█-█-█---------█---█---------█-█---█-----█---------------█-█-------█-█-----█-█-----------█---
-█-█-█-█-████--█-█--██---███-█-██-███--█-█████-█-█-█-█-███-███████-█-█-███-█---█-█-███-█-███-█-███-██
-█-█---█-------█-█-------█-------█-----------█-█-----█---█-----------------█-█-█-█-█---█-----█---█---
█--███████████-█-█-█-██--███-█---█---█-█-███-████-██-█-█-███-█████-███-█-█-█-████--█-█-███-█████--███
---------█-█-█-█-█-█-█-------█-------█---█-----█-█-----█-█-------█-█-█-█-█-█---█---█-█---█-█---------
---█████---█-█-█-█-█-█-███--█--█---█-██----█████-█-███-█-█-█-██-█--█-█-███-█-█████-███-█-██--█████-█-
---█---------------█-█-----█---█-█-█---█-------------█-█---█-----█-------█-█-█-------█-█---------█-█-
██-███---█-█-█-█-█-█-█-█-█-█-█-█--█-█--█-█-█-███-█---██-██-█-█-█-█-███---█-█-█-█-█---█-█-██-██-███-██
---------█-----█-█-█-█-------█---------------█---█-█-----█-█-█-█-█-----█---█-█---█-------█---█-------
-█-█-█-█████-█-█-█---█-██----███-███-██----███-█--████--██-█-███-█-██--████--███-███-█-████--█-█-███-
-█-----█-------█-█-█-█-█-----█---█-----------------█-█---█-█-----█---█-----█---█---█-█-------█-----█-
-█-█-███-█████--██-███---█-█--██-█-█-█-████--█-█-█---█-██-██-█████-█-████---██-█-█-█--██-█-█-█-███-██
---------█-----█---█---█---█---█---█-█-----█-█-█-█---█-----█-----------█---------█-█---█-█-█-----█---
-████████-██-██-██-█-████--█--██████-█-█-█--██████-█-███-█-███-█--███--███-█-█████-█-█-█████-██--█-█-
-█-----------█-----█-█-----█-------█-█-█-█-------█-█-----█---█-█-----█---█-█---█-----█-----█---█---█-
84 98