A--█-----------------█-------█-█-----------------█-█-------------------------█-----█-█-█-█-------█-█-
-███-████--█████-████---███-██-█-█-█--███--██-████-█-█-█-█-█-█-█████-███-███████--██-█-█-█---█-███-█-
-------------------------█-------█-------█-█---█---█-█-█-█---█-----█-█-█-----------█---█-----------█-
-███-██--███-██████-██-███-███-███████-█-███-█-███---█-███-█████-█-█-█-█-█-████-████-███-█████-█-███-
-----------█-----------------█---█---█-----█-------------█-█---█---█---█-█---█-----------------█-█---
---█-█-█-███-█-█████-█--██████-█---█-██████-████----██-█-███-██--██████--█████-███-█-███-█████-█-█-██
-█-█-█-------█-----█-█-------█-█-█-----█---█---------------------█---------█---█---█---------█-------
-███---█-█████████-█████-███████-█-███-█-█████---██--█████-████-██-█████-██--███-█---███████-█-███-█-
-----█-█---------█-█-----------█---------------█---█-----█-----█-------█---█-------█-------█-█-█---█-
-█████-█-███-██--██--█-█-█-█████████-███-█-█-█---███-█████████████-███-██-██-███-█--████-██--██████-█
-----█-----█-█-------█-█-█-----█---█-█---█-█-█-█---█---------█-----█-█-----------------█---█---------
-█-█-█-████--█-█-███-███-█-█████-███--██-█---█████-█-█-█-█-█████-█-█-███-████--███-███████--████-████
---█-----------█---█-----█---█-----█-█---█---█-----█-█---█---█---█-█-█-█-----█-----------------------
-█████-████--█-█-█-█████-█-██--█-███████-█---█-███-████--███-█-███-█-█-█---██-██-████-█-██████---██-█
-█-█---------█-█-█---█-█-█-----------█---█-█-█-█-----█---█-------------█-█---█---------█-----█-█-----
-█---█-███-█-█---██--█-█--█-██-███-█-█-██--█-████-██-███████-----█████---███████-███-███-█████---█-█-
-----█---█-█-█---------█---█-----█-█-█---█-█-----█-------█-█-█-█-----█-█---█---█---█-█-----█---█---█-
-███-█-█---██---████████████████---███-█-██--█-███-█-█-█-█-█-█-█-█-█-███-███-███-███-█-█████-███████-
-------█---█-------------------█-█-----█-█---█-█-█---█-█-----█-█-█-█---------------█-█---------------
██-█-█-█████-██████-██-█████-█-███-███-█-█████-█-█████-█-███-██--█-█-█-█----██-█████-█-█-█--██-██████
-----█-------█-█-----█-------█---█---█-------█-----█---█-█-------█-█-█-█-█---█-----█---█---█-█-█-----
██-█-███--█--█-█--█--███-█-█-█-███-█--██-█-████--█████████-█-███-█-█-█████-█████-█████-█████-███-█-██
---█-█-█---█-------█---█-█-█-█-----█---█-------█-█---█---------█-█-------█-----█---█-█-█---█-█---█---
-█-███---█-█-█-----███-█████-█-█-█-------██-████████-█-█---███-███-█-███-█-█--██████-███--██-█-████--
-█-----█-----█-█-█---------█---█-█-█---█-------█-------█-█---█---█-█-------█-█---------------█-█---█-
██-█-█████-█-█-█-███-█---███████-█-███-█---█-█-███-█-█-█-███-█-█-█-█-----███---█-███-███-█-███-█-███-
---█-----█---█-█---█-█-█-------█-----█-█---█-----█-----█-------█-█-█-█-█-----------█-█---█-----------
██-█-----███-███-█-██--███---███-█-███-███--██-█████--██████-█-█-███-██---██-███-██-████-██--█-█-██--
---█-█-█---█-█-█-█-█-█---█-█-----█---█-------█---█---█-█---█-█---------█---█-----█-----█-----------█-
-███----███----███-█--██---█-████-█--██----███████-█-█-███-█████-███-█---█-█-██-----████-███-█-███-██
-█---█-----------------█-█-█---█-------------------------█-----█-----█-█-█-------------█---█---------
██-█-█-█---█-█---█-█-█████-█████--███--█--██-███-█-█-█-██---█-████-███████-█-███--█████--███-█-███-██
---█-█-█---█-█-█---------█-----------█-█-█-----█-█-█-█-█-█-█---█-█-------█-----█-█---█-█---█-█-------
-█-█-█-███-█-███-███-█-█-█-█-█-█-█-██-██-█-█--██-██████----█-███-█-██--███-███-███-███-█████-█-█████-
---█-█---█---█-------█-█-█-█---█-█---█-█-█-█-------------------------█-█-----█-----█---------█-------
-█-█-█-█-███-█-█---███-█████-█-█-█-█-█---█-█-█-███-█████---█-█████-█-███-█-██--█-█-█-███-█-███-███-██
-█-█-█---█-------█---█-------█-█-█-█---█---█-█-----█---█-█-█-------█---------█---█-----█-█-█-█-----█-
-█-█████-█████-██-██-████-██-█████-█-██--███████████-█████-█-███████-███-█---█-█---------███-████-██-
-█-----█---------█-------█-█-----█-----█-------█-----█-█-------█-█-----█-█-█---█---█-█-█-----------█-
-███████-█-█-██--█-█--███--███-███-█-█---███-█-█-███---██-██-█-█-███-█-█-███████████-██---█--█-█--█--
-----█---█-█-█---█-█-----█---█-█---█---█---█---------------------█---█-█-------------█-----█---█---█-
██-█████-█--██--██-█-█-███-███-██--█-█████-█-███-███-█-█---█-█-███-██--███-██-██████----████-█████-█-
-------█-█-█---█-------------█---█-█---█---█-█-----█---█---█-█-█---█-----█-----█---█---█-----█-█-----
-███-███-███████---███-███-█████-███-█-█-█-███-█-█-█-███-█████-█-███-█-███-███-█-█-█████-█████-███-██
---█-█-------█---█-█-----█---------█-█-█-----█---█-█-█-█-------█-█-█-------█---------------------█---
███-----████████--████-███--██--██-█-█-█-█-█-███-█████--██-█-█████-█████-█-███-███-███--██████-███-█-
---------------█-█-------------█---█-█-█-----█-------------█-█-█-----█---█-█-----█---█-------█-----█-
-███████-█████-█--████-█-█████-█-██-████-█-█████-█--████████-█-----██--█-█████-██--███--█--█-█---█-██
---█-----------█---█---█-------------█---█-----█-█---█-------------█---------█---█-----█-------█-█-█-
-█-█████--██-█-███-███-█████-██--█-█-█-█-█-█-█-█-████--█-█-█-█--████-█-█---████----█--██-█████-█-███-
-█-█---------█-----█-----------█---█-█-█-█-█---█-----------█-█-------█---█-█-█-█-█-----------█-------
-██-█--█-█---█-█-█-█-█████████-███-███---█-█-██--█----████-█-███-█-███-█████-█-█-█-███-█████-█-█-█-█-
-█-----█-█-█---█-█-█---------█---█---█-█-█-█-----█---------█---█-█-█-█---------█-█---█-----█-------█-
-█-████-████-██--█-█-███-█████----██████-█-█--██-███-███-█--██-██-██-█-█-███-█-███-█-█---███-█-██-██-
-------█-----█-█-█-------------█-------█-█-█-█-----█-█---█-█-------------█-█-█---█-█---█-█-----------
---███-███-█-----███-███-███--██-█████-█-█-█-█-█-█-█-█████-█-███-█-█-█-█-█-█-█-██--█-██-████-█-███-██
-█---█-█---█---█---█-█---█-----------█-█-█-----█-█-█-----█-█---█-█-█-█-█---█-█-█---█---█-█-█-█---█---
-█-███--██-█-█-█-███████-█--██-█---█-███-█-█-█-█---█---█-███-█---█-█-█---████-█--███-█---█-█-█-█-██--
-----------█-█-█---█---------█-█-█-█-----█---█-█-█-█-█-█---█-█-------█-█---█---█---█-█-----█-█-█-█---
----██-█-██--█--██-██-██-█-█-███-█-█----████-█-█-███-█████-█-█-███-█-█--█--█-█-███-█--██-█-█-█-███-██
-█---█-█-----█---█-█-----█-█-----█-█-█-----█---█---█-█---█-█-----█---█-█-----------█-█-█-█-█-█-------
-███-█-██---████-█-███-███████-██████--█-█-█---█████-█-██-██-███-█-█████-------█████-█-███-█--███████
---------█-█---█-----█-------█-------█---█---█---█---------█-----█-█-----█-█-------█-------█---------
--██---███-█-█----████-██--███-█-██████-██---█████████-█-█-█████---█-███-███-██--███-██████████-████-
---█-█---█-----█---█---█-----█-█-------█---█-------█---█-█-█-----------█---█-█-█-------------█---█-█-
-███-█-█-█-█-█-███-█-█-███-█-█-█-██--████--██-██████-█-█-█████-███-█████████-█-███-███████████-███-██
-----█-█---█---█---█-█---█---█-█-█-█-----█-----------█-----█-----█-------█-----█---------█---█-█-█---
-███-█-███-█-█-█-█-█-█-█████-█████-█-█████-████---██-█-█-█████████-███-█-█-███-█████████████-█-█-█-██
-----█-----█---█-█-█-------█---█-----█-------------█---█---█---------█---█---------------█-----█-█---
██-█████---█-█-█-█-██--█-█-█████-█-█████-███-███-█---█-███-███-██--██-██-█-███---█-█████-█-█-███-█-██
-------█-█-█-----------█-█-----█-█-------█-----█-█---█-█---█---█---------█---█-█---█-█-----█---------
-██-██-██--█-█---█-█-███-█-█-█████-█--██-███-█-████-██████████████-█-███-█-███-█---█-█-███-███████-█-
-----█-█---█-----█-█-█-█-█-█-------█-█-----█-█-------█-█-----------█---█-█-█---█-█-------█---█---█---
-███-███-█-███-█-███-█-█-█-█-█-███████-██---█---████-█-██-█-██-███-██-█---██-█-█████-█-██-██-█-█--██-
---------█---█-█-█---------█-------------█-█-------█-----█-------█-----█-█---█---█-█-█-----█---------
-█-█-███-█████-██--█-█-███---███-█--██████-███----██-█-███-█-█---█-█--████-████-██--█--███-█-█-███-█-
-----█-----------█-█-█-------█---█-------█-----█---█-█-█---█-█-█-█-----█---█-█-█---█-------█-█---█---
██████-███-█-█-█-███-██--█-████████--█-███-█-█████-█-█████-█-█████-█████--██---█-███-█-█-█-█-████████
---------█-█-------█---█-█-------█-------█-█-█-█---█-█-----█---█-----█-█-█---------█-█---█-█-█-------
-█████-█████-█-█---█-█-███-█-███-█-█-█-███-█-█-███-███-███████-█-█-██--█---█-██-█████-████--████-████
---█---█---------█-█-█---█-█---█-█-█-█-----█-----█---█-█-█---█-------------------------█-------█-█-█-
███--█---█-█-█-█-█████-█████-███-████---███-██-█-█-█-█-█-███-█████-█-█████-█-█-█████-█--██-█-███-█-█-
-----█-----█-█-█-█-█---------█-------█-----█-█-█---------█-----------█-----█-------█---█---█-------█-
-█---███-███-███-█-███-█-█-███---█-█-████-██-█--████--██-█-█-█-█-█-█-█---███-█████---█████---█--████-
-█-█---█-█---█-------█-█-----█-█-█-█---------------█---█-█-█-█-█-█---█-█-█-----█-█-█-----█-█-█-------
████--█--█-█-████--██--█---█-█-█--██-██--█████-█---█-█-██--█-█-█-█-█-█-███--██-█-█████---█-██--█-███-
---█---█---------█---█-█-█---█---█-█-----█-█-█-█-█---█---█-█---█-█-█-----█-█-------█-----█---█-█-█---
██-█-███-████---█--█-███-█-█-█████---█-███---█-█-█████-███-███-█████--██--██-█-█-█-███-███-█--██-█-██
-------█---█-█-------█-█-█-█---█-----█-█-█-█---█---█-█---█-------█-----█-█---█-█-█-----█---█---█-----
-███-███-█-█-█--█--█-█-███-███-███-█████-█-█-██--███-█-███--██-█---█-█-████--█-██--███-█-█-███-█-█---
---█-----█---█-█---█-█-----------█-------------█---█---█---█---█-█-█---█-----█-█---█---█-█-█-█-█-█-█-
-█████-█-█-█-███████---█████-█-█-███-████--███████-█-█-█-█-███-███--██████-█-████--███-█-█-█-███-██--
---------█-----█-----█-------█-█-█-------█-------█-█---█-█---█---█-------█-█-----█---█-█-█---█-------
-█-█-█-█-█-█--██-█-█-█-█--██-███--██--██---█-███████-█-█-█████-█-█-███-█████--████-█-█-█-█-█-█--██-█-
-█-█---█-█-------█-█---█---█-█-----█-█---█-█---------█-------█-█---█-----█-------█-█-█-█-█-----█-█-█-
-█████-█--██-███████-█-█-███-███-███---█-█-███-███-██----██--██--█-███-█-█-██-████-█-█-███-███---██-█
-----█-█---█---------█-----█-█-----█-█-█-█-----█-█---█-█-█-█-█-█-█-█-----█-------█-█-█--------------G
-█-███-█-█-█---█████-█-█-█-█████-█-█████-█-█-███----█--█-█--█--█-███---███-█████-█-█-███-█-████████-█
-█-█-----█-█-█-█-----█-█-█-----█-█---█---█-█-----█-█-----------█-█---█-█-------█---█-█---█---------█-
██-███-█-███-██-██████-█-█-█---█-█-█████-██--█-█-█---███-███-█---█---█--█--█-█-███-█--██████-█-███-█-
-----█-█-█---------█---█---█---█-█-----█-█---█---------█---█-█-█-█---█-█---█-█---█-█-----█---█---█---
96 100