A----█---------█---█-------█-----█-----█---------------------█---█---█-------█-----█-----█---█-█-█---
-██-██-███-█████-█████-███---█-█-█---█-█--█████-███-██-█████████-█-███-█-█████-███--█--█-███-█-█--██-
---------█-----█-█-█-█-----█---------█-----------█-----█-█---█---------█---█---█-------█---------█---
-█-██--███-█████-█-----█--██-███████-█-█-███-█-███-███-█-█-█████-█-██--███-███-█--████-█-█████-███-██
-█---█---█-----█-----█---█---█-----█---------█-█-----█-----█-█-█-█-------█-------█---█-█-----█-------
██-█-█-█-█---█-█-████--███--██-█-█-███████-██--█-███-█-█-█-█-█-█-█-█----██-███-██-██-█-█-█-████-█████
---█-█-█---█-------------█-----█-------█-█-█-----█-█-█-----------------------█-█-█-------█---█-------
-█-███-█---█████-███-███-█-█████-█-█-███-█-███-███-█-███-███-█████████-███-████--█---█-█-███--██-███-
-█---█-█-----█-█-█---------█-█-█-█-█-█-█---------------█---------█---█---█-----█-----█-█---█-█-█-----
-█---█-███████-███████-█-█-█-█---█-██--█-█████---█-█████-██-██-█-█-██---███--███-███████-█████---█-█-
-█-█-----------█---█---█-█---------------█---█-----█-█---█-█-█-█---█-------█-█-----█-█-█-█-------█---
████-██-███--███-███-███-█---█--████-███-███-█-█████-█-----█-█-█-█-█-███████--██-███-█-█-█-█████████-
-----------█-----█-----█-█-█-----█-----█---------█---------█-█-------█-----------------------------█-
████-█-███-█-████--████████-██-█████-███-█---█-█-█-███-█-███-███-████--█-██-██████-███-█-█-██████████
-----------█---█-█---█---█-█---█---█---█-█-█-█-█-----█-█-----------------█-------█---█-█-█-----█---█-
-██████--█-█████-█-███-███-███-█-██████----███-█-█--████-█-█████-██████----█-█-███--████-███████-█-█-
---█-----█-------------█-█---█-----█-█-█-█---█-█-█-------█-----█-█-----█---█---█---------------------
-█-███---███-█-█-█-█---█-█-█████-█-█---███-█-█--██---█-█-█-█████-█--██-██-██---███-███--██-█-███-█-██
-█-----█---█---█-█-█-█---█---█---█-----█-█-█-█-----█-█-█-----█-------█-----█-█-█---------█-----█-█---
-███--██-█-███-█-███-█-███-█-█--████-███-█-███-█---█-█-██--██-████-█-█-█---█████████-█-█-█-███████---
-█-█-█---------█---█-█-----------------------█-█---█-█-----------█-█-█-█-------█-----█-█-------------
██-███-█-█-█-█████-█-█-███-█---█-███-███████-█-█████-█---███-█---█████-█-█-█-███-█-███-█████-█-█---█-
-------█-█-█---█-█-----█-----█-----█-------█-█-█-----█---------------█-█---█-█-█-----█-----█-█---█-█-
█--█-█-█████-██--█████████-███-██-██████-███-███-███-███--██-█-████-█-██-████--█-█-██---██-█-████████
-----█-------------------█-█---------█-----█---█---█-█-----█-█-----------------█-█-█-█-█---█-█-------
-█-█-███-█--█--███--██-████-█-██-███-█-█-█-███-█-███-█---█████-----█-█-█-██████-████-█--██--█--█-████
---█---█-█---█-█-----█-----█-█-----█-█-█-█-█-█-█-█-█---█-----█-█-█-█-█-█-█-█---█---------------------
█--█-█████-█-███████-█-███-█-----██-█████-█--██--█-█████-█-███-█-███████-█-█-█--██--█--█-███-███-█-██
---█---█---█---█-█-----█-█-█---█---------------█-█-█---------█-█-------█---------█-█-----------█-█---
-█-█-█-█-███-███-███-███-███-███-█-█-█████-█████-█-███-█-█-██-██████-███-█-█-█-███-█-███--█-████-███-
-█-█---█-█---------█-------█-█---█-█---█---------█-----█-█-█---█-█-█---█---█---█-------█-------█---█-
████-█-█-██--███████████-█-████-███████████--█████-█████-█-█-███-█-█████-█---█-███-██-████-█-██-████-
-----█-█-█-------------█---------█---█---█-█-------█-█-------█-█-----█-█---█-------------█-█-----█-█-
██████████-█-████-██--██-██-████-█-█-█-███-█--████-█-----█-█-█-█-███-█-██--█-█-██--████-█-████-█---██
-----------█-----█-------------█---█-------------------█-█-█-----------█---█-----█---█-█-------------
-███-███-██----█-█-█-███-██--█-█████-█-████--█-█---█-███-█-█-███-█---█-██----███---███-█-█-█-███-███-
-----█---█-----█-█-█---█---█-------█-█-------█-█-█-█-█---█-----█-------█---█-----█-█---█---█---█---█-
-█-█-███-█-█-█---███████---█-█-███-███-█-█-███-█-███-███-█---█-█-███-█████-██████--█-███-█████-█-████
-█---█-------█-█---------█-█-█---█-█-█---█-█---█-█-█---█-█-█-█-█---------█-------█-----------█-----█-
██-█-███-█-█-███-███-███--██████-█-█-███████-█-█-█-█-███---█-█████████-██--█-███-███-███-█-██-██-█---
-----------█---█---█-----█-█---------█-█-----█---█-----█-█---------█---█-------█---█---█-------█-█-█-
-█-█-█-█-█████---████---██-█-█████-█-█-█-█████-█-███-███-█--█--██████-██████████-█---███████████-███-
-█-█-█-█-█---------█-----------█-█---------------█-------█-----█-----------█---█-█-█-----------█-----
-██--██████--███-█---██-██-█-█-█-█-█-██-████-█████-███-███-█-█████-████-███--███████-█-███-█-███-█-█-
---------█-----█---█-----█---------------█-█-----█-█-----------------█---------█---█-█---█-█---█-█-█-
██-█--████-█-███-█-█-█---█-█████-█-███-███-█████-█-█-█--██████-█-██-██-█████-███-█-█-█-█-█---█-█-█-█-
---█-█-------█-----█-█---█-----█-█---█---█-█---█-█---█-----█---█---------█-------█---█-█---█-█-█-█-█-
██-█-█-█-███-█-█-███-█-█-█-█-█-███-████------█████-███-█-█-███-███-█-█-████--███████-███-█-███████---
-----█---█---█-█-█---█-█-█-█-█---█-----█---█-----------█-█-------█-█-█---█-█---█-------█-█-█---█-----
-█-█-███-███-█-█-█-███-█-█-███-█-█-█-█████████-█████-████--██████--███-█-█--██-█--█-██-█--██-███--███
-█-█-█-█---█-█-------█---------█---█-------█-█-----█-----█-----█-█-----█---█---------█-█---█---█-█---
██-█-█-█-█-█████-█-█-█-█-█-███-█---█-████-██-█----███--███-█-██---██-███-█---██-████████-███-█████--█
---█-█---█---█---█-█---------█---█-█---█-█-█-------█---------█-█-------------█-----█---█---█-----█-█-
-███-█████-█---█-█-███-█-█-█-█-█████--██---███-██-██████-███-█-█-█-██████-████---███-████--█--████-█-
-█---█-----█-█-█-█-------█-█-█-█-------------------█---█---█---█---------█-----------█-█-█-----█-█-█-
-█-█---█--██████-█████████-█--█-██-█-█-███████-█████-█-█-█-█-█████---███---█-████-█-█--█-█-█-███-█-█-
-█-█-█-█-----█-----------█-█---█---█---------█-------█-█-█-█-------█---█-----------------█-█-█-------
-█-███---█-█-███-█-█-█-█-█-█-██-█--█-█████-███-███--██--████████-█-██-██-█-███-███--██------█--██--██
-█-█-------█---█-█-█-█-█-█-█-------------█-----------------█-----█-----█-█-------█-----█-█-------█-█-
-█--██-█-█-█-███-█-█-███-████---██-█-█-█-████--█----██--███--██---███---████-█-█-███--██-█-█████████-
-█---█---------█-█-█---█---█-----█-----█---█---█-█---█---------█-------------█-█-█-------█---█-█-█---
-█████-█--██-███--██████-█-██--█-█-█---██████-████-█-██---██-███-█-███-███-███-█-█-█████-█-███-█-█-█-
-█-------█---------------█-█---█---█-------█-------█-█-█-------█-█---█---█-█-------█---█-----█-------
███-██-██-██-█-███-█-█-█-███-███-█---█---█-███-███-███-██████████-██-███---█-██--███-███---█-█-█-█-██
-------------█---█-█-----█---█---█-█-█---█---█-------█-█-------█---█---█-------█-█-------█-------█---
-█-█-█-█-██--█---███-█-█-███████---███-███████-█-█-█-█-█-█████-█-█-█-███-█-█-█-███-█-█-█--██-█-█-█-█-
-█-█-█-----█---█-----█-█-█-------█-------█-█---█-█---------█-----█-█-█---█-█-------█-█-█-█-█---█---█-
██-█-█████-███-█████-█████████-█-█-███-█-█-█-█-█-█-███████-███-█-█--████-███-█--█--█-█-███-██--█--██-
---█---█---------█-----------█-█-█-----█---█-█-█-----------█---█-█-----█-----█---█-█---------█-----█-
██-█-█-███--██--████-█-█---█-██--█-█-█-█-█-███---█-██----██-██████---█----██-███-█-█-█-███-███-███-██
-█-█-█-█---█-█-█---█-----█-█-█-------█-█-----█-█-------█---------█-█-█-█---█-------█-█---█-----------
-█-██--███-█-█-█-███-█-█-█-█-█-███-█-█-███████-█-██████--█-█-█--██-███-█---█------██-███-███████-█-█-
-----█---█---█-----█-----------█-----█-----█-----------█-----█---█---█-█-█-█-█-█---█---█---------█-█-
---█-█-█---███████-███--████----█--███-█-█-██--█--█-██-███-████-███-████-███-███-█████████-█-█-█-█-██
-█-█-█-----------█-█---------█-█-----█-█-█-█---█---------█---------█-----█-----█-------█---█-█-------
---█-█-█-█-███████-█-█-███-███-█-█-█-█-█-███████-███-██--█--███-██-█████---█-█████-███-███-█-█-███-█-
---█-█-█-█-█-----█---█---█-█---█-█---█-█-█---------█---█-█---█---------█-█-------█---█-█---------█---
-███████-███-█-█-█-█-█████-███████-█-███-█████-███-█-███-███-█---█-███-█----██████-██--█-███-█-█-██-█
-------------█-█-------█---█---█-█-█---█-█-----█-------█---█---█-█-----█-------------█-----█---█-----
-██████--███---█-█-█-███-█-█-███--██--████-█-███-███-█-███-█---█-█-█-█-█████-█-█████-█-█-█-██--█-███-
-█-----------█-█-█-█-█---█-----------------█-█---█-------█-----█-█-█-█---█-------█---█-█-----█-█---█-
██-███-███-█-█-█-----███-█-█-█-█--██-█-█-███-█-█-█-█-█-█-██--███-█-███-███---███-█---█-█-█-█-█-█-█-██
-----█-█---█-█-█-----█---█-█---█---█-█---█---█-█-█-█---█-------█-█-------█-----█---█---█---█-█-█-█---
-█-█-█████-█-███-█-█-█-███-███---█-█-███████-█---█-██--█-███████-█████-███-█-█-█████-█████-███████-██
-█-█---█-█-█---█-█-█---------█-█-█-█-█-------█-█-█-█---------█-------█-█-█-█-█---------------█-█---█-
-█-█-█-█-█-█-██--█-█████-█--████-█-█-█████--██-█-█-███-█-███-███-███--█--█--████-███-██████-██-████--
-----█---█-----█-------█-█---█---█---█-----------█---------█-█-█-█---------█-█---█---█---█-----█---█-
█-█--█-█-███---█-█-█-█---█-█-█-█-█████████-██--█--██-█-███-██--█-█-█-█---███-███-█-█---█---█████-█-█-
-----█-----█-█-█-█-█-█-█-█-█-█-█-------█---█---█---█-█-------------█-----------█-----------█-█-█-----
-█---█-███████-█---███████-----█████████-███-█-█-█-███-█-█-█---█████-███-█---█-█--██-█-█████-█-█-████
-█-█-█-------█---█---█-----█---█-------█---█-█---█---------█-----------█-█-█-█-█-█---█---------------
-███-█---█-█-█-██-██--█---██-█████████-█--██-█-█████--██-███-█-███-█-█████-███████-█-█-█-----█-███-█-
-----█---█-█-█-------█---█-------█-----------█-----█-----█---█-█---█-----------█-----█-█-█-█-█-----█-
-█-█-█-█-█-█-█---███████-███-█-███-█-█-███-█-███-█---███-█-█-█-███--██-█-██--█████-█-███-███---███-█-
---█-█---█---█-█---█-------█-█-----█-█-█-----------█---█-█---█-█-------█-----█---█-█---█-█---█-----█-
-█████-█████-█-█-█-█████████-█--██-█--██-█-████---██████-███-██--████-████-█-█-█-█--██--█--█-█-█-████
-----█---█-█-----█-----█---█-------█---█---█-----------█---█-------------█-----█-█---█---█---█-█-----
-█-███-███--██-██████--█-█-█-█-█████-███-█-███-███-███-█-███-██████████-█████--█-█-███████--████-█-██
-█---█-█-█-----------█-█-█-----█-------█---█---------█---------█-------█---------█-------█-------█-█G
-█-█████-█-███-███-██-█-██-█-██--█-█-█-█---█-███---███-█-█-█-█-█-█-█--█--███-█-█████-███-█-█-█-███---
-█---------------█-------█-█-█-----█-█-----█-█---█-----█-█-█-----------█-----█-----█---█-█-█-----█---
98 100