A------█-------█---█-█-------█-█-█-----------------█---█---█-------█-█---█-█-█-------█---█---█-█-----
---███-█-████-██-███-█-███-███-█-█-█-█--███████-██-█-█████-█--██--██-█-███-█----██████-█████-█---██-█
-█---█-------█-------█---█-█-------█-----█-█---█-█-█-█-----█---█-----█---█-█---█-█-------------------
--██-███-██--█-█-█-█-█-█-█-█-█-█████-███---█-█---█-█---██----███-█████-███-█-█-█-█-██████--█---███--█
-█---█---------█-█-█-------------█-█-█-█-----█-----------------█-█-█-------------█-------█---█-------
-█-█-█-█-█-█-█-███-█████-█████-███-███-█-████--██--███████---█████-███-██-████-███-█-███-█-█-█-█-██-█
-█-------█-█-█-█-------█-----█---------------------█---█---█-----------------█-----█-----█-█---█-----
-█---███-███-█-███-███████-███-█-█-███-██--███-█-██--██--██████--█-█-█-█-------███-█-███████-█-███-██
-█-█---█---█-----█-----█---█-█-█-█-------█---█---█-█---█---█---------█-█---█-█---█-█-------------█---
-█-█-█---██--██--█-█-█-█-█-█-█████-███████-█-███---█--██-█---███████-███-███-███--███████-█-██-█-████
---█-█-----█---█-█-----█---------█-█---------█-----█---------------█---█---█-█-----------█-█-█-█-█---
-███-█-█████-███-███---█████-███-███-█-███████-█---█-█-█-█████████-█-███-██--█-███-█-█-███---█████-██
-█---------█-█-----█-█---------█-█---█-----█---------------------█-█-█-------█-----█-█-----------█---
-███-█-█-█---█-█-██--██--████████-██-█---█████-███-█████████-█████-██--█-████-█████-████-███-█-███-██
---█-█-█-█-█-█---█-----█---------------█-█-█-----------------█-█---█---█-█---█-█-█-----█---█-█-------
-███-█-███-███████-█-█-███████--████-█--██----██-█-█-█-███████-███-█-█████---█-█-█████-███████████-█-
-█-█-------█---------█-------█-----█-█-------█-█-█-█-----█---------█-------------------------------█-
██-█-█-██--█-█-███-█-█-█-██-██-██--████--█-███-█-█-███████-█--██-█-█--██-█████-███-█-█-███-████-███-█
-----█-----█-------█---█---------█---█---█-----------█---------█-█-█-█---------█-█-█---█-█---█---█-█-
██-█-█-█-█-█-███-███-███---██----███-█-██--█-█-███-█-█--█--█-███-███-█-█-█-█-███-███████-███-█-███---
-----█-█-█-----█-------█-█-█-█-█-----█-█-----█---█-█-----█-------█-----█-█-█---------------█-------█-
-█-█████-█-█-███---█-███-███-█-█-█-█-█████-█-█████-████████--█-███-█-█-█████--██-█-█-███-█-██--███-█-
-----█---█-----█-█-█---█-----█-█-█-█-------█---█-----█-█---------█-█-█-█---█-█---█-█-----█---█-█---█-
-█-█-█-█-█-███-███-█-█-███-███-█-███--█-████-█--██-███-█-█-██████--█-███-█████-█-███-██████████--███-
---█---█-----------█-█-------█-----█-------█---█---------█---------█---------█-█---█---------█-█-█---
██-█-█-███-█-██--█-█-█-█-█-█-█████-█-----█████████-█-█-██----██████--████████████--███-█-█---█---█-██
---█-█-----█---█-█-█-█-█-█-------█---█-█-----█---█-█-█---█-█-█-----█-█-----█-█---█-----█-█-█---------
-███-███-█-█--██-█-█---██----█-███-███-███-██---██-███████-███-██--███-█████-█-█-████-██-█-█-████████
-█---█-----█---█-█-█-█-█---█-█---█-█-█---█-------------█-------█-█-----------█-█-----█-█-█-----█-----
---█-███-█---█--████--██-██-██---█-█-█-█-███--██-█-█-███-█--█--█-███-████--███-███-█-█---█-███████-██
-█-█-█-█-█---------█-------█---█-----█-----█---█-█-----█---------█-█---------█-█-█-█---█-------------
-██-██-█-█-█-██████████--█████-███-█-----███-█--██████████-███-███--███--█-███-█-█-█-███-█-███-██████
-█-█-----█-█-------█---------█---█-█-█-------█-█-█-------█-------█-----------------------------------
---███-█-█-█-█-█-███-█-███-█-█-█-███-████-█-██-█---██-████████████-██-█-█---██---███████-█---█-█-███-
-█-----█---█---█---█-█-█-----█-█-█-----------█-------█---█-----█-------------█-█-█-----█-█-█-█-█-----
-█-█-██--█-█-███-███---███-███-█-█-█-█-███████-███-█-█-█-█-███---█-█---███-█-███-█-███████-█-████--█-
-----█-█---█---█---█---█-------█---█-█---█-------█-█-----█---------█-█-------█-------------█-----█-█-
██-███-█-███-███-█-█-█-█-█-█-█████-█---███-█████-█-█-█-███-█-█-█-█-█████████-█-███---█████-█-█-█-████
-█-█-------█-█---█-█-█-█-█-█---█---█-█---█-█-------█-------█-█-█-----█-----█---------█---█-█---------
-███-█---███-███-█-█--██████-███-██-████-███-██-██-███-███-███-█-█---█---███-███-██--█-█-██--███-█-██
-----█-█-------█-█---█---█-------------█-█-█---█-----█---█-----█-█-----█---█---█---------------█-█---
-█-███-█-█-█-███-█████-█-█-█-█-█-█---███-█-█████--██-█-█-█-█-███-███████-█-█-█-█-███-█-█-█-█-███-█-██
---█-------█---█-----█-█-█---█---█-----------█---█---█---█-█-█---------█---█-------█-█-█---█---█-----
---███-█-███-███--██-█-█-█-█-█-█-█-█-█-█-█-█-█-█-█-█---█-█-█-█-------███-█-███████-█-█-█████-███████-
-------█-█-----█---------█-█-█---█---█-----█---█-█-█-----------█-█-------█---█---█-----█-█-█---------
-█-███-█--██████--██-█-███-█---███-█████---█-█-█-█--██-█-██--██-████-██-██████-████---██-█-██--█-█-█-
-█-█---█---------█-█-----█-█-█-█-█-------█-█---█-█-█---█---█---------█-----------█-█-█-█---█-----█-█-
██-█████-█---█-█---███-█-█-██----███---███████-███████-█████---█-███████-█-█-███-█-███-█-█-█-████████
---------█-----█-----█-█-█-----█-█-█-------------█-------█---█---------------------█-----█-----------
█--█████-█-█████-██--█--██████-█-█-███---█-█-███---███████████-----█--██████-█-█-███-█---█-█--██████-
---█-----█-----█-----------------█---█-█-█-█-█---█-█-----█-------█-█-------█-█-█-█-------█---------█-
██-█-█-█-█████--██-█-█-███-███-█-█-███-████████--█-█-████--██--███--██-███-█████--██-███-█-█-████████
---█-█-█-----█-----█-█---█---█-█---------█---█-----█-----█-█-----█---█-█-----------█-------█-█-█-----
-█-███-████--█-█-███-███-█--█---██████████-█---███-█-███-█████-███-███-█---█-█-█--██---█-█████-█-█-█-
-█---█-----█-█-----█-█-█-█---█---█---------------█-----█---------█-█---█-█-█-█-█-█-█-█---█-----█-█-█-
-█-█-█-█████-█---███-█-█-███-███-█-█-██-████-█-█-███████████-█-█-████--█████████-█-█-█-█---█████-████
---█-------█-------█-█-----█-------------█-█---█-------------█-█-----█---------------█---------------
██-█-█---█-████-██--██-█-█-█████-█--█--███-█-██-██-███████---█-█-███-███-███-█--██-██--███-█-█-███--█
---█---█-█-----█---█---█-█-------█---█-----------█-------█-█-------█---------█-█---------█---█---█---
-███---█-███████-█-█-█-█-█-█-█-█-█-██████--█-█-█████-███-██---██-███-███-█--█--█-█████-███-███-█-█-█-
---█-█-█-----█-█---█---█-█-█-█-█-█-------█-█-█---█-----█-█-█-█-----█---█-█-----█-█-█---█-----------█-
████-----███---█-█-█-████-██---███-███--██-███-██-█-██-█-█---█-█-█-█--██-███-█-██--█-█-█-█-███-██--█-
-█-█---█-█-█-█---█-█---█---------█-█-------█---------█-█-█-█---█---█-█---█---█-----█-█-█-█-█-----█-█-
-█-█-█--██-█████-█-█-█-███-█-█-█████-█-█-█---█---█-███-███-█-███---█--██-███-███-██-██████-█-███-█---
-----█---------█-█-█---█---█-█-█-█---█-█-█---█-█-█-----█-------█-█-█-█-█-█-----█---------█-------█-█-
--██-█████-█████████-██--█-█████-█--██-█-██-██--██-███---█-█-█-█-█-█---████--██--█-███-█-█-█████-███-
---█---█-----------█-█---█-------------█-█---------------█-█-█-█-█-█---█---█-█-----█-█-█-----------█-
██---███-█---████-██-█-█-█-█-█-█-█-█████-█████-█-█-█-█-█-███-█-██--█-███-██--█-█-█-█-███-█--███████-█
---█-█---█-------█-------█-█-█---█-----█---█-█-█-█-█---█-█-------█-█-█-------█-█-█---█---------------
██-█-███-██████-███████--█-███--█--███---███-███-█-█-█-███-█-█-█-██--█--██-█-███-█---█-█-█--███-█-██-
---█---█-------█---------█-█-----█---█-█---█-----█-█-█-█---█-█-█-------█---█---█---█-█-█-█-----------
████--██-█-██-█--█████-█--████-█-███-████-████-█-███-█████-███---█-█-█-█-███-█-███--██-███-█-█-█-███-
-----------█---------█-█-█-----█-█-----------█-█-------█---█-█-█---█-█-----█-█---█-█-█---------█-----
██---█-███-█-█-███---███████--██-█-███-█--██-███--███--█████-█-█-█-█-█-███-█-██--█-█---███████-█-----
---█-█-----█-█-█---█-------------█---█-█-█-----█---█-█-----█-█-----█-█-█---█---█-█---█-█---------█-█-
---█-█-█-█████-███-███-█-██---████-█--██-█-█-█-███-█-█████-█-███-██--█-█-█-█-█████-█████-█-█-█████-█-
-█-█-█-----█-------█---█-█-----------█-█-█---------------█---------█-----█-------█-------█-█---█-----
-█████-█-█-█-█-███-██--███-█--████---█-███-█---█-███████████-█-█████-█-███---█████-███-███-█--██-█-█-
---█-█---█---█-█---█---█-█-------█-█-----█-----█-█-█-█-█-█-█-█-----█---█-█-█-█-------█-------█---█-█-
-█-█---█████-█--█--█-██--███-███-█-█-█-█-███---█-█-█-█-█-█-█-███████-███---███-███-█-███----██████-█-
-█-------█-------█-------█-----█---█-█-█-█-----█-----------█-█---█-█-█-█---------█-█---█-█-----------
█-████-█-█---█-███-███-█-███-███████-█████-█-█-███-█---████-█---██-███-----█-███████-█████--████████-
-------█---█-█---------█-█---------█-----█-------█-█-█-----------█-----█---------█-█-█---█-----█-----
█--█-█-█████-█-█--██---█-███-█-█-----█--██----█--███████-███-█-███-██-████-█-█████---█---███-█---█-█-
---█-█-----█-█---█---█-█-----█-█-█-█-█---█-█-█-█---█-█-█-----█---------█-█-█-----------█---█-█-█-█---
-█--█--█-███-██████--█-█-███-███---█-█--████-█-█-███-█-█-███-█-███-█-███-█-██████--███████-████-██---
-----------█---█-█---█-----█-█---█-█-------█-----------█---█-█-█-------█---------█-------█-------█-█-
-█-█-█-█--██---█--████-█████-█-█-███--██-█-███-█-█-███-█████-█████--████---███-█-█████-███-███-█-█-█-
---█-█-█---█-------█-----█-----█-█-----█-█---█-█-█-█-█-----█-----█-----█-█---█-█-----█---█-----█-█---
██-█-███-█--██-███-█-█---█-█-███-█-█-█-██--█---█-█-█-█---█████-██--█-█-███-█-█████-█-█-█-█--██-█-███-
-------█-------█---------█-█---------█---█-█---█-----█-█---█-----█-█-█-█---------------█---█---█-█-█-
-█-█████-█--██-█-█-█-█-███-███---█-██████--█-███████-█-██████--█-█-█-█-█-█---█-██--█-█-█-█-███-█-█--█
-------█-----█-------█---█---█-█-█---█-----█---█-█---█---█---█-----█-█-█-█-█---█---█-█-█-█---█-█-----
-█--██-██--█████-███-█-█-█-█-█-███-█-██-██---█-█-█-----█-█-█████-█-█-███-█-█-██-█--█-██-█-████-█-█-█-
-█---█-----█-------█-█-█-█-█---█-█-█-----█-----█-----█---------█-█---------█---█-█-█-----█-█-█-------
-███---███-███--█-██-█-███-█-█---███-███-█----██---█████-█-███-████--█-██----█-█-█████--██-█-█-█-██-█
-----█---█---█-█-----█-█---█-----█-----█-█---█---█-------█---█-------█---█-█-------█---█---█-█-█-----
-███-█-█-█-█████-█████-█████-█---█-█-███-████--█-███-███-█████-█--████-███-█-███-███-███-███-█-█-██-█
-------█---█-------█-----█---█-----█---█-----█-█-█-█---█---█---------█-█---█-█----------G----█-█-----
---██--██--█-███-████--█--██-█-█-██--███-█-█-█████-█-█-█-█-███-█-█-███-█-█-█-█-███--█--███-███-█-██-█
-█-------█-█-█-------█-█-█---█-█---█-------█-█-------█-█-----█---█-----█---█---█-----█---------█-----
98 88