A--------------█-------█-----------------█-█---█-█-------█-----------█-----█-█-------------█-█---█---
-███-█-█-█-█████-█████████████-█-█-███-█-█-███-█-█-███-███-███████████-█████-█-███-█-█████-█-█-█████-
---█-█-█-█-█-█-█---█-----█---█-█-█---█-█---█---------█-█-----█-----█-█-█---█-█---█-█---█-█-█---█-----
-█-███-█-█-█-█-█-███-█████-███-█-█████████████-█-███████-█████-█████-█-█-███-█-█-███████-███-███-████
-█---█-█-█-----█---█---█-------█-█-█-█---------█-█-----█-█---█-█-----█-█-█-█---█-█---█-█-------█---█-
-█-███████-█████-█-█-█████-███████-█-███-█████-█-█-█████-█-███-█-█████-█-█-█-█████-███-█-███████-███-
-█-----█---█---█-█-----█-----█-█---█---------█-█-█-----------█-█---█-------█-------█---█---█---------
-█-███████-█-███-███-█████-███-█-███-█████████████-███-███████-█-███-███████-█-█████-███-█-███-█-███-
-█---█---█---------█-------------█---------█-█-----█-------█-------█-█-█-█---█-----------█-█-█-█---█-
-███-█-███-███-█████████-█████-███-█████████-█-███-███-█████-█-█████-█-█-█-███████-███-█-███-█-█-████
---█-----█---█---------█-----█---------█-█-█-█---█---█-█-----█-------------█-----█---█-█-------█-█---
-█████-███-███-█-█-███████████-█-█-█-███-█-█-█-█████████-█████-█████-█-█-█-█-█████████-███████-█-█-██
---█-----█-█-█-█-█-----------█-█-█-█-------------------█-----█-█-█-█-█-█-█-----------█-------█-█-----
-███-███-█-█-█-█-███-███-███████-█-█-███-███-█-█████-███-███████-█-█-█-█████-█-███-███████-█-█████-██
---█---█-█---█-█-█-█-█-----█---█-█-█-█-----█-█---█---█-------------█-█-█-█-█-█-█---------█-█-█-█-█---
-█████-███-█-█-█-█-█████-███-█-███-█████████-███████-█-███-█-█-███████-█-█-███████-█████████-█-█-████
---█---█---█-█-█-------█-----█---█-█-------█---█---------█-█-█-█-----█-------█---█-------█---------█-
██████-█-█-█████-█-███████-███████-█-█-█-███-█-███-█-█-█████-█-█-███████████-█-█████████████████-███-
-------█-█---█---█---█-------█-█-█-█-█-█---█-█---█-█-█-----█-█-----█-█-----█-█-█---█-█---█-----------
-█-█-█████-█████-█-█-█████-███-█-███-█████-█-█-█-███-█-███-███████-█-█-███████-█-███-███-█████████-█-
-█-█-█---------█-█-█---█-----------------█-█-█-█-█---█---█-------█-█---------█-----█-█---█-█---█-█-█-
████-█████-███████-█-█-█-█-█-█-███-███-███████████-█-█-█-█-███-███-█-█████████-█████-█-███-███-█-█-██
-------█-█-------█-█-█-█-█-█-█---█-█-█-----█-------█-█-█-█---█-█-------------█-█-█-----█-█---█-------
██-█-███-█-███-███████-█-███-█████-█-█-███-█████-█-███████-█-█████-█-█-███████-█-█-█████-█-█████████-
---█---█---█---█-----█-█-█-------█---█---█---█---█---█-█---█-----█-█-█---------------------------█---
-█-█-███-█-███-█-█████-███-███-█-███████-███-█-███-███-███-███-█-███-███-███-█-█-███-█-█████████-███-
-█-█-█---█---█-------█-█-----█-█-------█-█-█-█-█-------█-█-█-█-█---█---█-█-█-█-█-█-█-█-------█---█---
████████-█-███-█-█-█████████-█-███-███-█-█-█-███-█-█-███-███-█████████████-█████-█-█████████-███-███-
---------█---█-█-█-----█-----█---█-█---█---█---█-█-█---------------█-------█-█-█---------█-█---█-█---
-███-███-███████-███-███████-███-███-███-█-█████-███-█-███████████-███-█-███-█-███-███████-███████-█-
-█---█---------█---█---█-█---█-----█-█-█-█-----█---█-█---------█-------█-------█-█---█---------█-█-█-
-█████-█-█-███-█████-█-█-█-█-███-█-█-█-███████-█████████-███-███-███-█-█-█-███-█-█████-███████-█-█-█-
-----█-█-█-█-█---█-█-█-█---█---█-█-█-----█-█-----------█---█-█-█-█---█-█-█---█---------█-----█---█-█-
-█-█-█-███-█-█████-█████-█-█████-███-█████-███-███-█-███-███-█-█████-█-███████-█-█-███-█-█████-█████-
-█-█-█-█-----------█-█-█-█-----█---█-------█-█---█-█-█---█-------█---█-----█---█-█---█-------█---█---
-█████-███-███-█████-█-███-█-███-███-█████-█-█████████-█-███-█-█████-█████-█████-███-█-█-███-█-█████-
---█-----█---█---------█-█-█---█---█-█---█---█-------█-█-█---█-----█-----█-----█---█-█-█---█-█---█---
-███-█-█████-███-█████-█-█-█-███████-█-█████-█-███-███████████-█████-█-█-█████-█████-█-███████-█-███-
-█---█-█-------█-----█---█-█-----█-----█---█---█-------------█-█-----█-█-----█-----█-█-------█-█---█-
████-███████-█-███████-███████████-█-█-███-███-███████████-█████-█████-███████-█-███-███-███-█-█-███-
-------█-----█-------█-------█-█-█-█-█-------█---█-█-----█-█-----█-----------█-█-█-█---█-█-█-█-█-█-█-
████-█-█-█-█-█-█-█-█████-█████-█-█████-█████████-█-█-███-█-███-███████-█-█-███████-█-█-███-███-███-██
-----█-█-█-█-█-█-█-█-█-█-------------█-----█-█-█-----█-█-█---█-█-------█-█-█---█---█-█-------█---█---
██████-███-█-█████-█-█-█-█-█████-█-███-█-█-█-█-█-███-█-███████-█████-█-█████-█████-███████████████-██
-------█---█-----█---█-█-█-----█-█-█---█-█-----█---█---█---█-█-█-----█---------█---------█-------█---
██-█-█-█████-███-█-█-█-█-█-█-███████████-█-█-█-█████-█-█-███-█-█████-█-█-█████-███-█████-█-█████████-
---█-█-█-----█---█-█---█-█-█---------█-█-█-█-█---█-█-█-█-█---█-█-----█-█-----█-█-----█-█---█---█-█---
-█-█-█████-█-█-█-█-█-█████-███████-███-█████████-█-█████-███-█████-█-█-███████████-█-█-███████-█-█-█-
-█-█-█---█-█-█-█-█-█---█---------█-----█---█---█-----------------█-█-█-------█-----█---█-----█-----█-
-█-█████-█-███-█-███-███-█-███-█-███████-███-█████-███-███-███████-█-█████-█-█-███-███████-███-██████
-█---█-------█-█-█-----█-█-█-█-█-----------█-----█-█-----█-----█---█-----█-█---█-█-█-█-----█-█-------
██████████-███████-███████-█-███-█-███-█████-█████-███-█-███████-█-█-███-███-█-█-███-█-█████-█-█-█-██
-█---█-█-------█-█---█-------█---█---█-------█-█-█---█-█---█---█-█-█---█-█---█-█-----█---------█-█---
-███-█-█-█-███-█-█-█████-█-█████-█████-███████-█-███████-███-█████-█-█-█-█-███-█-█████-█-████████████
---------█---█---█-█-█-█-█---█-------█-----------------█-█-------█-█-█-█-█---█---------█---------█-█-
██████████-███████-█-█-███-█-█-█-█-███-█-███-█-█-█-███-███-███-█████-███-█-███-███████-███-███████-█-
-------------█-█---------█-█-█-█-█-█---█---█-█-█-█---█-------█-█-------█-█-█---------█---█-----------
██████-███-███-█-███-█-███-█████-█████-█-█████-█-█-███-███-███-███-█-█████-███-███-█-█████-█-█-███-██
-█-█-----█-----█---█-█-█-------█-----█-█-----█-█-█---█---█---█-█-█-█---█-----█---█-█-----█-█-█---█-█-
-█-███████-█-███-█-█-█-███-███-█-█████-█-█████████-█-███████████-███-█-███-█-███-█-███████████-█████-
-----------█-█---█-█-█-█-----█-█---█---█---------█-█-------------█-█-█---█-█-█---█-------█-█---------
██-█-███-███-███-█-█-█-█-███-███-███-███-█-███-█-█-█████-█████-███-█-█████-███-█████-█-█-█-█████-███-
---█---█---█---█-█-█-█-█-█-----█---█---█-█-█-█-█-█---█-----█-----█-----█---█-----█-█-█-█-------█---█-
██████-█-█-███-███-█-███-█-█-█-███████-███-█-███-█████████-███-███-█-█████-███-███-█-█-█-█-█-█-███-█-
---█---█-█---█---█-█-█---█-█-█-------█-█-------█---------█-█-----█-█---█-█-█-------█-█-█-█-█-█---█-█-
██-█-█-███-█████████████-█████-███-█-███-█-███-█-███-█-█████-█-███-█-███-█-█-█████-███-█-█-███████-██
-----█-█---------█-█---------█---█-█---█-█-█---█---█-█-----█-█-█---█-----█-█-█-----█---█-█-------█---
-█-█-███-█-███████-█-█-█-███-███████-███-█-███-█-█-█-█-███-█-█████-█-███-███-█-█-█-███-███-█-███-████
-█-█---█-█-----█---█-█-█-█---------█---█-█-█---█-█-█-█---█-█-----█-█-█-----█-█-█-█---█-█---█---█-█---
-█-█-███-█-█-███-███-█-███-███-███-███-█-█-███-███-█-███-█████-█-█-█-███-███-███-█-███-█-███-█████-██
-█-█---█-█-█-------█-█-█---█-----█---█-█-█-█-----█-█-█-------█-█-█-█---█---█---█-█---█-█---█---------
-█-███████-█-███-█-█████-█-█████-███████-█-███-█████████-███-█████-█████-█████-███-█████-█-███-███-█-
-█-----█-█-█---█-█-█-----█-█-----█-█---█-█---█---------█-█-----█-------█---█-█-█-----█---█-█-----█-█-
██-█-█-█-███-███████████-█████-███-█-███████-███-█-█-█-█-███-█████-█-███████-███-█-█████-███-███-█-█-
---█-█-█-------█---█-----█-█-----------█-------█-█-█-█-█---█-----█-█---------█---█-----█---█---█-█-█-
██-█-███-███-█-█-█████-███-█-█-█████-█-███-███-███-█-███-█████████████████-█-███-█-█-█-█████-███████-
---█-█-----█-█-----█-------█-█-----█-█-█-█-█---█---█---█-----------█---█-█-█---█-█-█-█---█-█-------█-
-███████-█-███-█-███-█-█-███-█-█████-█-█-███-█-█████-█-█████-███-█████-█-█-█████-█-███████-█-█-███-██
-█-------█-█---█---█-█-█---█-█---█-█-█-----█-█-█-----█-----█-█-----------█-----█-█-█-------█-█---█---
-█-█-█-█-█████-███-█-█████-█████-█-███-███████-█████-█████-█-█████-█-███-█-███████-█-███████-█-██████
-█-█-█-█-█-------█-█-█-█-----█-------█---█---█-█---------█-█-█---█-█-█---█-█---------------█-█-█-----
-█████-█-█-█-█-█-█-███-███-███-█-█-█-███-█-█-█████-█-█-█-█████-█-█-█-███████████-███-███-█████-█-████
---█---█-█-█-█-█-█-█-------█---█-█-█-█-█---█---█---█-█-█-----█-█---█-----█-------█-----█-█---█-------
-█-███-█-█-█-█████████-█-█████-███-███-███████████-███-███-█████-█-█-███████-███-███-█-█-███-█-██████
-█-█---█-█-█---█-------█-█---█-█-------------█---█-█-----█-█-----█-█-----█---█---█---█-█-----█-------
██-███-█-███-███-███-███-███-█-█-███-█-███-█-█-███-█-█-███-█████-███-█-█████-█████-███-███████-██████
---█---█---█-█-█---█-█-----█---█---█-█---█-█-----█-█-█---█---█---█---█-----█-█-----█-█-------█-------
████-█████████-███-███-█-███-█-█████-█-███-█████-█-█-███-███████████-█-███-█-█████-█-█████████-███-██
-----------█---█---█-█-█---█-█---█---█---█-----█-█-█---█-----█-█-█-█-█-█-█-█-█-----------█---█-█-----
-█-█-█-█-███-███████-█████-█-█-███-█████-█-███-███-█-███-█-███-█-█-█-███-█-█-█████-█-█████-███-█-█-██
-█-█-█-█---------█-█-------█-█-█-----█---█---█---█-█---█-█---------█-----█-█-█-----█---------█-█-█--G
████-███-███-█████-█████-█-███████-█████-█-█-███████-█████-███-█-█-█████-█-█-█████-█-█-█-███████████-
-------█-█-----█---------█-------█-----█-█-█-------█---█-----█-█-█---█---█-█-█-----█-█-█-------█-----
██-█-███-███-█████-█-█-███-█-███-███-█-█-█-█-█-█-█-█-███-█-███-███-███████████-███-█-███-█-█-███████-
---█---█-█-----█---█-█-█-█-█---█---█-█-█-█-█-█-█-█-█-█---█---█-█-------█---█-█-█---█---█-█-█---█---█-
██-█████-█-███-███-█████-█-█████████-█-███-███-███-█-█-█-█-███-███-█-███-███-█████-█-███-███-███-███-
---█-----█-█---█-█---█-------------█-█-█-----█---█-█-█-█-█---█---█-█-----------█---█-█-█---█-----█-█-
-███-█-███-█-█-█-█████████-█-███-███████-███████-█-█-█-█-█-█-█-█-███-███-█-███████-█-█-█-█-█-█-███-██
---█-█---█-█-█-------█-----█-█---█---█---------█-█-█-█-█-█-█-█-█-█-----█-█-----█---█-█---█-█-█-------
██-███-█████-█-█-█████-█-█-█████-█-███-█████████████-█-███-█████████-█████-███-███████-███-█-███████-
---█---█-----█-█-----█-█-█-----█---█---------------█-█-█-----█-----------█---█-------█-█---█-------█-
90 100
DEMO FILE