A█-----█-█-█-------█-█---█---█-------█-------------█-----------█-█---█-█-----█---█---------█---█-----
--██-██--█---█-█████---███-███-█-█-█-█-███-█--█████--█---███-███-█-█-█-█-███████-███-████--█-███████-
-----------------------█---------█-█---█-█-█-------█-------█-----------█---------█---█-----------█---
-█-█---███-█-█-█---█-█-█-█-█-██-██-███-█-██-███████--█████-█████████-███-█-██████--███-█████--██-█--█
-█---█-█-█-█-█-█---█-----█-█-----█---------------█-█-----█-------█-------█-█-█-----------------█-█---
-█---█-█-█-█████-----██-██-█████-█-███-██-█-████-█-█-█---█████-█-█-██--███---██---█-████-████-██-█---
-█-█-----█-█---------------█---█-█---█-█-----█-█-█-----█-█-█-█-------█-█-█-█---█-------█---█-----█---
█--█-█-██-███----███-█-█--██-█████-█-█████-█-█---█---███-█-█--█-█--█████-█-█-██--████████--█-█████-██
-----█---█---█-█---█-█-█-----------█-------█-█-█-----------------█-----------█---------------█-█---█-
-█-█-███-█-███████-█-█---█████-███-█--██-█-███-█-███-███--████-███████-██--█-███--██-█████████-█-█-█-
-----█-----------█-█-█---█-█-----█-----█---█-----------------█-█-----█-█-█-----------█-█-------█-█-█-
████-███---█-█--██-█-█-█-█-█--████-█-██-██-█-█-█----█-██-██████--█-██--█-███-█---█████-███-█-███---█-
---------█---█-----█-█-█-█-----█---------------█-█-------█---█-█---█---█---█-█-█-█---█---------█-█---
-█-█-█-█--████-████-████████-█-█████-█-███-███-█-███████-█-█-█-█-█████-█-███-█-███-█-█-██████--█-█-█-
-█-█-█-------█-------------█-█-------█---█---█-------█-█-█-█-------------------█---█-------█-█-----█-
██-███---█--███-██-█-█████-█-█████-█-█---███-███-███-█-█---██-█-████-███████-█---█-█-███-█-█-██-████-
-------█-█-█-█-----█-----█-----█---█-█-----█-█---█-█---█-----█-█-█-----------█---------█-----------█-
--██-███-█-█-█-███-█-██████-██████-█-█-█-█-█-█-█-█-███-███-███-█-███--██-██-████-█-█--█--████-███--██
-█-------█-------█-█-----------█---█-█-█-------------█-----------------█-----█-----█-----█-------█-█-
██---█-██-██-███████-█-█--██████--██-█-█-█-█-█-█-███-█-█-█████-█-█-█-█████-███-███████-███-█-█-███-█-
---█-█-█-------█-█-█-█-█-----█-------█-█-█-------█---█-█-------█-█-█-----█-------------█---█-------█-
██-█████-█-█████---█-█-█-█-█----██-█--████-█-█████-█-███-███-████-██-████-██-█-█-█-█████-███--█---██-
---------█-----------█---█-█-----█-------█-█-----█-█-----█-█-------█-----█---█---█-------------█-█-█-
██-█-█-███-█-█████-█-███-█--██-█-█---█-███-█--██-███-█████--████-███████-█-█-█-█--████████-████----█-
-█-█-█-█---------█-█---█-█-------█-█-█-█---█-█-----█-----------------------█-----█---█-█-█---------█-
-█-█-█████-█---█████-███-█-███████-███-███-█-█-█-█-█--██---███-█████-█-█--█████-██-█-█-█--█████--█-█-
-----█-----█-█-----█-----█-█-----█-█-----█-█---█-█-█---█-----█---█---█---█---█-----█-------█---------
-███-█-█-███-█---█-██-██-███-███████-█-███-█-███--██-███-███-███-███-█████-█████---█-█-██-████-███-██
---█-█-█-█---█-█-█---█---------------█---█-█---█-█-█-----█-----------------------█---------█---------
--██-███-███-█-█-████--█-█-███-███████-███-███-███-████-██-█-████--█-█-█-███---█-█---█-█-███-████████
-█-----█-----█-█---------█---█---█---█---█---█---█---█-█---█-----█-█-█-█---█-----█-█-----█-----------
-█-█-█████-██--█-███-███-█---█--█--█---█-█████-███-██--█-█████████-█---█-██--███--██-█-███-█-█-███-█-
-█-█-█---------█-█-----█---█---------------------------------█-█-█---█-█---█-█-------█-█-█---█---█-█-
██-███-█-█-████--█-█-███-█████-█-██--███-█-███-█-█-█-█-█-███-█-█-█-███-█████████-███-███---█████-█-█-
-----█-█-█-----█-█-█---█-█-------------█-█---█-█-█-█-█-█---█-----█-█-█-----█---█---█---------█-------
██-███-█-█-█-███-█████--██--████-███-███-███-█-█-█-█████-█-█--██-█-█-███-█████-█-█████-█-█-███--██-██
---█---█-█---█-------█-----------█-█---█-------█-█-------------█-█-----█-----█-------█-█-█---█-█-----
-█-█-█-█-███-█-█-███-█--█--█---██--█████-█████-█-█-█-█-█-█████-█-█████████-█---█████-█████-██--███--█
---█---█---█-█-█-----█---█-█-█-----------------█-█-█-█-█---------█---------█-----█---------█-█-----█-
---█-█-█-█-███-█-█████-█-█-█---█-█-███-█---█████-█-█-█-███---███-█-█-█-█-█-███████-█---██----███-███-
---█-█-█-----█-█---█-█-------█-----█---█-█-----█-█-█-█---█-█---█-------█-█-------█-█-█---------------
-█-██--█-█-█-█-█-█-█-█-█-█-███████-███████-█-█--██---█-███--█-██-█-███-█-███████-███-█████-█████-----
-------█-█-█-█-█-----█-█-█-------█-----█---------█-----█-------█-█-█---------------█---█-------█---█-
-█████-█-█-█-█-█-██--█-█--█--█-█████-█--██-███-███-█-█-█-█-█-█████-█-███---█-█-█-█-----██--█-█-█-███-
-----█---█-█-█-------█---█---█-----------█---█---█-█-█---█-█-------█---█-█-█---█-█-█-█---█-█---█-█---
-█-█-█-██-████-█---█--████████-█-███-█---█-----█████-███-█-███-██--███-█████-█-███-███-███-█-███-█-██
-█-----█-█-------█---------------█-█---█---█-█---█---█---█-█-----█---█-------█-------█-----█---█-█---
-█████-█-█████-█---███-████-██-███-███-█-███-█-█████-█-█--███-██-█████████-███-█-███-█-███-█-████-███
-█-------█-----█-█-█---------█-----█---█---█-----█---█-█-------█---------█---█-█-█-------█-----------
-█-█-██--███████-█████-███-█-█-█-█████--███--█-█-█-███-███-█-█-██--█-███-█-█---█-███-█----██-█-█-███-
-█-█-█---█-----------------█-█-█---█-------------█---█---█-█-----█-----█---█-█-█-----█-█-█---█-----█-
██-███-█-█-█-█-███-███-█-█-█████---------███████-█---█-███-█-██-███--█-█-█-████-█--█---███-█-███-██-█
---█---█-█---------█---█-█-----█-█-----█-------█---█---█---█-█-█-------█-█---█---█-█-█-█-█-----------
████-█-█-█████-█--█-██-█████████████-█-█-████-████-█-█-██--█-█-█-███---████--█-█--█--█-█-█-█-█-█--██-
---------█-----█-█---█-----------█-█-█-█-----------█-█-█-----------█-█-█---█-------█-█-█---█-█-----█-
██-█-███████-█-██----█-███████████-███-████-████--██████-██--█---███████-█-█---███-█████-█████-█-█-██
---█-------█-----█-------------------█-------█-█-------█-----█-----█-------█-█-█-█-----------█-█-█-█-
██████████-█-█-███-█-█-███-----███-█-███-███-█-███-██--█--█--█-█-█--██-█████--██-█████-██████--█-█---
-------------█-█---█-█-█-█---█---█-----█---█---------█-█-█---█-------█-------█-----█---█-------█-█---
-█-███-█-█████-██--███-█-███-█-███-█--██-█---█-█-███--██-█-█-█---██-██--██████-█████-█-███---███-███-
---█---█---█-----█---█---█---█---█-█-----█-█-█-█-█-----█-█-█-█-----------█-█-------█-█-█---█-█---█---
██-████--█-█-█████████-████--██-██████-█████-███---██-██-███████-███-█-█-█-███-████--███-█-███-█-█-█-
---------█-----█-----------█-----█-█-------█---------------█-------█---█-█-------█-█-----█-█---█-----
-█-███-█████-█████-███-███-█-----█-███-██-████-███-███-█--█-█--█-█████-█-█-█-█-███-███-██--█████-█-██
-█---█-█-----------█-----█-----█---█-█-█-------█-█---█-█---█---█---█-█-█---█---------█-█-------█-█---
████-█-██------███-███-█-----███-██--█-█-█-██-██-█-█----████-█-█--██-███-█████---█-███-███-█-█-█-█--█
-----█-█---█-█-----█---█-------█-----█---█-------█-█-█-----█-█-█-------█-█---█-█-----█-█---█-█-█-█---
--██-███-█-█-███--██-█-█-███-█-█-███-███-█████-█--██-█-█████-█-█-█---██-███--█████████████-█████-███-
-█-----█-█-█-█---█---█-█---█-█-█---█---█---------█-----█---█---█-█-█-------█---█-█-----█-----█-------
██-█-█-█-███-█-█-█-█---███████-█-█-█████-█████-██-██-█-█-████--█████-█-█-███-███-█-████-████-███-██-█
---█-█-█---█---█---█-█---------█-------█-----█-----█-------█-------█-----█---------█-------█---█-----
-█████---██-██-█--██-█-███-█████-█--██-███-█--██-█---█-█--██-█-█-█-███-██--█████-█-█--██-█████-██----
---█---█-█-----█---█-█---█-------█---█-█-█---█-█-█---█-█-----█-█---█---------█-█-█-----█-----█-█---█-
--█████████--███-█-----█████--██-██-████-███-█-███-███-█--██-██--█-█-███-█-███-█-███-█-█-█-███████--█
---█---█-█-----█-█---█-----█-█-------------------█-█---█-█-----█-█-█-█---█---------█-------------█---
-█-█-███-█-█-███-█-███-███████-█-█-█-████-█████--███-█-█-███---█-█-███-███-███████-█-███-█-███-█---█-
---█-------█---█-█-█-█-----█-█-█-█-█-----------------------█-█---█---█-█-------█---█-----█---█-█-█-█-
-██-██-██--█-███████-███-███-███████-█████-███---█████-█-█-██-████-█-█---██--█-█-█---█-█-█████-███-█-
---█-----------█-----------------█-█---█-█---█-█-----█-█-█-------█---█-█-█---█-█-█-█-█-█-----------█-
-██-█-██-█████--████-█-█-█-█-███-█-█-█-█---███████-█-█-███-███████-█-█████-███-█-█--██-█-█-███-█-██-█
---█-------█---█-█-█-█-█-█-----█---█-█---------█-█---█-█-------█-----█-------█-█-----█-█-█-█---█---█-
████-███-█--██-█-█-█--████-█-█-██--█-███-█-█-██--███████-█-█-███-███---█-█-█-███---███-█████-███-█-█-
-----█---█-------------█---------------------------█-----█-█-----█---█-----█-█---█---------█-█---█-█-
--██-█-███████-███-█-████-██---█-█---█---█-███-█████-███-█-█-███-███-█--██-█-█████-█---█--██---█-█-█-
-█-█---█-------█---█-█---█-------█-█---█-█-----█---█---█-█-█-------------█-------█-█-█-█---█-█-█-█---
█--█-█-█████████-█-█-█-█-█-███-███-█████-███-█-█-█-█---█---███-██--█████-█-█-█-███-█-█-█-███--██-███-
---█-█---█-█-----------█-------------█-----█-█-█-------█---█-----------█-█---█---█-----█---█-█---█---
-█-███████-███-█-██-██---█-█-█-█-█-█-█-███-█-███----███-████-█--██-----███████-███-█--██-█-███-███-█-
---------------█-----█---█-█---█-█-█-----------█-█-------█-█-----█-█---█---█-█-█-█-----█-█-----█-----
██████---█---████--█-██----█-█-█---███-█-███-███-█-█---█-█--██-█-█████████-█-█-█-███-█-█-███████████-
---------█-█---------------█-█-█-█-█---█-█---------------█-█-█-█-------█-------█-----█-------█-------
-█-███-█-███-█---█-█---███-█-███-███-█-███-█-███-█-█-█-███-█-███---███-█-████----████----███████---█-
---█---█-█---█-█---█-█-█---█---█-----█-█---█-----█---█-----------█-----█-------------█---------█-----
-██-████-█---█--██-███-██--█-███-█-█-██-█--███-█--████-█-███-█---███████-█-███-█-███-███--██-█-█████-
-----------█-█-█-----█-█---█---█---█-------█---█-----█-█---█-█-------█-█-█---------█---█-----█-----█-
-█████-███-█-█-███-█---█-█-█-███-█-███-█--█--█-███████-███-█-█-███████-█-██-██-█-██-████--█----█-███-
---█-----█-█-█-█-█-█---█-█---█-------█-█-█---█-----█-█-█---█-------------█-----█-----------█-█-█-----
-███-█-█-█--██-█-█-█-█-█-█-█-█-███-█-████-████-█-█-█-██████--████-██-█-█████-██--█████----████-█-███-
---█-█-█-----█---█-█-█-----█-█---█-█-----█-█-----------█-----------█-█-----█-█---------█---█-█-█---█-
-█-██-██-█-█████-█-█-█-███-█--██-█-█-█-███-██--███-█-█---█-█-█-█-█-███-███-███-██-██-█-██-██-█-█-███-
---█-----█-------█-█-------█---█-█-█-█-------█-█---█---█-----█-█-█-█---------------█-█-------█-█--G█-
100 98