A--█-█---------------█---------------------------█-----█-█---█-------------█-█-█---█-█-█-------█-----
-███-█----█--███-█---█-█-███████-██-██-███----██-█-████--███-██--█-█-███-███-█-█-███-----█-█-███---██
-------█---█---█-█---------█-█-█-----█-----█---█---█-█-------█-█-█---█-----------█-█-----█-█-----█-█-
-█-███-███-█████-███-█-█-███-█-██-█-██-█-██--█████---███-█-███-----███-██████-█-██--██-███---█-█-█-█-
-█---█-█-----------█---█---█---█-------█---█---█-█-█---█-----------------------█-█-----------█---█---
-███-█--███-█--███-█-█-██-██-███-█-█████████-█-█-█-█-█-█-█-█-██--█-███-█-██-█--█-█--████████-███-████
---█-█-------█-█-█-█-----█-------█---█-----█-------------█-----█-█---█-█---█-----█-------------------
-███-███-███-█-█--██-███-█-███-███-███-█-███--██-█████-█-█-███-█-███-███-█-█-█████-█-█-█-█████████-██
-█---█---█-----█---█-█-------█---█---█-----█-█---█---█-----█-----------█-█-----█---█---█-█-█-█-█-█-█-
-█-█-█████-█-█-█-███-█--████-███-█-█-----███-████--███-█-████-██████████-███-███-███-█-███-█-█-█-█-█-
-----------█-█-----█-------█-█-█-----------█-█-█-----█-█-----█-█---------█-------------------------█-
████-█-█████-█--██████-█--████-█████-█████-█-█-███--██-███-███-███-█████--██-███-█-█-██--█-███-█████-
-----█-----█-█-----█---------█-█-----█-█-█-------█-------█-------------█---------█-█---█-█---█---█---
--██--████-█---█-█-███-█-█-█-█---██-██---█-██--███-█████--██-█-████-----████-███-█-█----█--█-█---█-█-
-█---------█-█-█-█-------█-------█---█-------█---------█---█-█-----█-------█---█-----█-█-------█---█-
-█-█-█-█-█████-███-███-███-█-█████-███-███████-█-█-███-███-█---█-█--████-█-█-███-██-██-█-█████-████--
-█-█-█-█-----█---█-█-----█-█---------------█-█-█-█---█---█-█---█-█-----█-█-█---█---█-----------------
-██--█████-██-███████-██-███---██--██--███-█--██-█-█-█---███-█████-███████-----█-█-███--████--██████-
-█-----------█-------█-█-----█---█---█---█-----█-█---█---█-----█-█---█-█---█-█---█---█-----█-----█---
██-█-███-█-███-█-█-█-█-█-█████-███████-█-███-███-█-███-█-█-█████-████----███████-█-█-█-█-█-██-██-█-█-
---------█-------------█---█-----------█-█---------█---█-------█---█-█-█-█-█-█-█-█-█-█-█-------█-█-█-
████-█-████████-██████████████------██-█-███████-███-█--██-█████-█-█-█---█-█---█████-█-----█-█-██-██-
-█---█-------------------█-----█---█---█-------------█-█-----------------█---█-█-█-█-█-█-█-█-█-█---█-
-█-█-███-████████--█-█-█-███-██-██-█-█-███-█--█-██-█-█-█--██████-███-██-█--██--█-█-█---█-█-█-███-███-
-------█---------█-█-█-█---█-█---█-█---█-█-█-------------------█-----█-------█-█-----█-█---█---█---█-
████-█-█-███-█████-█--█-█--█-█-████--███-█---█-█-█████-█-█-█-█-███-███-█-██-██----██-█-█-█-██--█-█-█-
-----█-█---█-------------█-----█-█---█---█-█-------------█-█---█-█---█---█-█-------█---█-█---█---█-█-
████-█-█-█-█-█-█--██---████--█-█-███-█-█-██████--█-███-█-████--█---█-█-█---█-█████--██████-███-███-██
-------█-█-█-█-█---█-█---█-------█-----------------█-█-█-█-█-█-█---█-------█-----------█---█-█-------
--████-█---█████-█---█-███-███████-█-█-█-███-███-█-█-██--█-█-███-█████-█████-█-███-█---█--██-----█-█-
---█---█-------█-█-█-█---█-------█-█---█---█---█-█---█-█-----------█-█-█-█---█---█---------█-█-█-█-█-
█-██---██-██-███████---█████-█-███-█-█-██-███-███-██-█-███---█-█-█-█---█-█-█-█-█-█-██████-██--████-██
---------█-----█-█---█---█---█-█---█-------------█---█---█-█-█---█-----------█-----------█-----------
-██--█-█-███-███-███---██-████-███-█-███-█-█-█████-███-█████-█-█-███-████--███-█-█████████--██-█-█--█
-█-█-█-----█---------█-█---------█-█-█---█-█-------------█---█-█-------------█-----█-------------█-█-
██-█-███-█-██████████--███-█-███-█---█-█-█--██-██-██████-█-█-█-███-█-██████--█-█-█-█-███-███-█-█████-
-----█---█-█-----█-------█-█---█-█-█-█-█-█-█---------------█---█-█-█-----█-█---█-█-------------------
██-█-█-█-███-█-████-██-█-█---█-█---███-█-█--██-█---█-███-█-█-█-█----██-█-█-█----██████-██████-████-█-
---█-█-█---█-█-█-█---█---█-----█-█-█---█-█-----█---█---█-█-------█---█-█-----------█-█-█---█-█---█---
-███--██-█-█-███---█---█-███-----███████-█-█-██--█-█-███-█-███---█████-█-█████-█-█-█-█---█-█-█-█-███-
-█---█-------█-█-----█-█---█-█---------█-█---█---█-█---█-█-----█-----█-█-----█-█---------█---█-█-----
-█-█-█-█-█-██--█-███--██████--██---███-█-█-█████-█████-█-█-███-█---███--██-█████████████-█-█-█-█-████
-█-█-█-█-█---------█---█-█-█---█-█---█-█-█---------█-█-█---------█---█-█-------------█-█-█-█-------█-
-█-█-███-█---█---██--█-█-█-█-███████---█-███-█-█-███-█████-█-█-█████-███████-██--█████-███-█-█-█-███-
---█-█---█-█---█-█-█-█-----█---------█-█---█-------------█-█-█-----█-------█-------█---█-----█-█-----
-█--██-██--█-███-█-█████-███-███████████-███-███-█-█████-███-██-████████-████--█-█-█-███--█-██-███---
-█-------█-----█-----------------█-------█---█---------█---------------█---█---█-------------█-█---█-
████-█-███-█████---██--███-██-██-█-█--████-█---█--██-█████-█-█████-----█████-█-█-███---█---█-███-███-
-------------█---█-------█---█-----█-------█-█---█---█-█---█-------█-------█-█-█---█---█-█-█-------█-
-█-█-███-██--███-█-█-█-███-███---█████---█-███-█-█--██-█-█-███-█████-█-█-█████-█-█-█-█-███-█-█-█████-
-█-█---█---█---█-█-█-----█-----█-----█-█-█-█-------------█---█-█---█-█-█-----█-█-█---█-█-█-█---█-----
-█-█-█████████-█-███-██-█--█-█████-█-███-███-█-█-█-███-███-███-█-████-████-███-█---█-███-███-███---█-
-█-█---█-----█-█-------█---█---█-█---█-------█-█-█-█-█-█-█-----------█-----█---█-█-█-------█-█-------
-█-█-█-█-█-█-███-██--█-███-█-█-█-███-█████-███-█████-█-█---███████--████--████-█-█-█-█-█-███---█---█-
-█-█-----█-█---█-█---█-----█-█-----█-----█-█-----------------█-█-------█---█-----█---█-█-------█-----
-█--████-█-██--█-███-██-█████--█-█████-█████████-█-███---█---█-█-█-█-█-███-█-█-██--██--██████-████-█-
-█-----█-█---█-█-█-----█-█-----------------------█---█-█-█-█---█-█-█-█-----█-█-------█-------█-------
-█-███-█-█-█-----█-███-█---█-█-█-█-███-█-█-████--█-█-█-█-██-█-██-███-███████████---█-█-█-████--█-█-██
-█---█---█-█-█---█-█-----------█-█---█-█-------█-█-█-█-█-█-----█-█-█---------█---█-█-█-█-----█-█-----
-█--██-█--██-███-██-█----███-███---█████████-█-███-█-█-███--██████-███--██-█████-███████--███--█-██--
-█---█-█-█-█-----█-----------█---█-------█-█-█-█---█-█-------█-----------█---█-----█-█---█-----█---█-
-█-███████-█--██-█-█-█-██--███-█-█-█-█-█----██--█----█-███████-███████-███---███-█-█-███-█-██-████-█-
---█-█---------█-█---------------█-█-█-----------█-█-----█---█---------█-------█---█-█-----█---█---█-
-███-█████-█-█-█-███-███-█---█-█████-█--██-█-█---█-█-█-███-█-█████-██████-███████--█-█████-███-███--█
-█-----------█-█-----█---█-█-█---█-----------------█-█---------------█-█-----------------█-------█---
-█████-█-█-█████████-███-███████-███-███-███-█-█-███-██--█-███---█-███-██-██-███-█-█-█████---███████-
---█---█-█-█-----------█-----█-------------█-█-█---█-█---█---█-█-█-█-------█-█-----------█-█---█-----
█-█-██-██-██████-█---█████-███-█-█-█-██---█████████████--█--██-█████-████--███-█-█--████████-█-█-█-██
-----------------█-█-----█---█-█-------█-----█---------█-------------------------█-------█-------█---
-███-█-███-█████-██--█-█-███---███-█-█-█-█-█-█-█████-█-██████-██████-█-█-███-███-██--█-██--█-█████-██
-█-------█---█---█---█-█-----█-█---█-█-█-█-----------------█-█-█---█---------█-----█-█---█-█---------
██-█---█-█-█--█--█-█-█---█-███--██████-█-█-█-███-██-██-█---█-█-█-██-████-███-███-███-████-█---██-██-█
---█-█---█-█-█-----█---█-█---█-----█---█-█-█---█---█---█-----█-█---█-----█-----█---█---█-------█---█-
-█-███-█--█-██-█-███-█-█---███-█-███-█---███-██--█████-█--██-█-█---█-█████-████-████-█-█-█---█-█-███-
-█---█-█-█-----------█-█-----------█-█-█-█-----█-█---█-█---█-----------------█-------█-█---█-█-------
██-█-██-████-███-█-███---█-███-█-███-███████-███-█-███-███--██-█-███-████████--███-█████-███-█-███-██
---█---█-----█---█---█-█-----█-█---█-----------------█---█---█-█-█-----█---█-----█-█---█-█-------█---
█--█████-█-█-███-█-█-███-█-█-███████-█-█████-█████-██--█-█-█-█-█-█-█████-█-█-█-█-███-██--█████-███---
-------█-█-█---█-█-█-------█---█-----█-█---------█---█-█---█-█-█-█-------------█-------█---█-----█-█-
---█-█--██-█-█-█-█-█-█---█-███-█-██████-██-█-----███-█-█-█-█-█-█--██-█-█-█-█-███-██-██-███████-█-█-██
---█-█-----█-█-█-----█-----█-----█---█-------------█-█---█-█-█-█---█-█-█-----------------█-█---█-█-█-
-█-█-█--████-█-███-█--████-█-█-█-█-███-█████-████-█-██-█-█-███-███-█-█-██---████-█-███-███-█-█-█---█-
-█-█-█-----█-█-------------█---█---------█-█-------------█-█-█-█---█-█---█-----█-----------█-█-----█-
--██-█-███-█-█-████--██----█-█-█-█--██-█-█-█-█-█-█-█-█---█-█---█-█---█████-███-███-█████████-███████-
---█-█---█-----█-------█-█---█-█-█---█---█-----█-█---█-------█-█---█---█-----------------------------
-█--████-███-███-█-█-█████████-███-█---████-██-█-███-█-███-████-██-█-███-█-█-█-█-█████--██-█-█-█-█---
-█---------█-█-----█-------█-----█-----------█-█---█-----█-█-█---█-█---█-█-█-█-█---█-█---█--G█---█-█-
--██-█-█-███-███████--██-███-█-██-██-█-█--██████████████████-█---███-██--█--██---█-█-█-█-███--██-███-
-█---█-█---█-█---█-█---█-█---------█---█-█-█---█-█---------------------█-█---█-------█-█-------█---█-
-█-█-█-----█-███-█-█-█-██████--██-██████-█-█---█-█-█-█-███-█-█-███████-█-█-█-█████-█-███-██--█-██████
-█-----█-----█---█---█---█-----------█-█-------------█-█-█-█-----------█-█-█-----█-█---------█---█---
-█-█-█-█---█-███-█-█-█████-███-███-███---█--█████--███----██-█-█-█-███████-█-███-███-█████--██-█-█-█-
---█-----█---------------█-█-----█-------█-----------█-█---█-█---█-█-----█-----█-----█---█-█---█-----
██-█████-█-█-███---█---█████-█-█-███████-█-████-██-█-█-█-█████-█████-█-███-█-█-███-███--██████-█-█-█-
---█-█---█-█-█-----█---█-----█-█-------█---------█-█-----█-█-----------█---█-------------------█-█-█-
██-█-███-███-███-██--███---█---█-█-█-█████████--█--█████-█-███-█████--██-█-█-█████-█-█---█-██-██-███-
---█-------------█-----█-█-█---█---█-------------█-----█-----█-█---█---█---█-----█-█---█-█-█---------
-█-███--██-█-█████-███-█-----█-█-█-█-█-█████-████--█-----██████--██--███████---███-███-███████-█-████
-█-█---█---█-█-------█-█-█---█-█-█-█-█-----█---------█---█---------█---------█-█-----█---------█-----
-█-███-███-█████-█--███--█████-█-█---█-█-█-███-███-██-██---███████-███-█-█---█-██--███████████-███-██
-█-----█-----█-----█-------█---█-█-█-█-------█-█-------█-------------█-█-█---█---------------█---█---
86 92